The Logical Song
The Logical Song - Remastered 2010	Supertramp	Breakfast In America (Deluxe Edition)	spotify:track:6mHOcVtsHLMuesJkswc0GZ
The Logical Song	Pomplamoose	The Logical Song	spotify:track:4fjRccBf27YXtUid7IVv5D
The Logical Song	Sexton Blake	Plays the Hits!	spotify:track:0W4ESndw0gGto0itQXLydd
The Logical Song	Roger Hodgson	Classics Live	spotify:track:1xgTn29SjvkWcyXsmqcg6q
The Logical Song	The Philistines Jr.	The Logical Song	spotify:track:0fvWTRNfSXhlzITSbb0kiu
The Logical Song	Banda Do Sul	Electro Bossa Classics	spotify:track:4aB7VfyccG2lr9iTWNZZo4
The Logical Song	Pedro Javier González	Guitarra, Vol. 2	spotify:track:62MWLDlgFRz3IhRLQrW0km
The Logical Song	Dream Baby	'80s Lullabies	spotify:track:5u8MqeQPMPqYLwH8G8iYBJ
Logical Song	Pink Turtle	Pop in Swing	spotify:track:2JLt3fToknsdu6x0GjJmHw
Logical song	Vosakiz	Logical song	spotify:track:5w2P0VSVxdW9FFxObHqo4c
The Logical Song	Joe Crookston	Able Baker Charlie & Dog	spotify:track:6XektGy8YZ631r1eK83gHh
Logical Song	The Previews	Fool's Overture	spotify:track:4d6W1EeQdEHLMnkLt125Om
The Logical Song	The Holophonics	Maskarades. Vol. 15	spotify:track:6EDRcLFrLiBr8Y4mGkMzu1
Logical Song	33Tours	Stereoscope	spotify:track:4RzUMMg5kbkdF7QNxZC8iX
Logical Song	América de Vigo	Knights of Rock	spotify:track:5UdqCcHJqdRlpZJtkds0S0
Logical Song	Old Flames	No Guitars Allowed	spotify:track:2NUMjj5uUVGauQliK6yPer
The Logical Song	Gillan Cash	Live at Browns (Deluxe Edition)	spotify:track:0vAsvb3UuHChzCenfjYiiT
The Logical Song	Symphonic Rock Project	The Supertramp Songbook	spotify:track:6fWso0trecPeLe4azMEnBd
Logical Song	Pavic	Taste Some Liberty [European import]	spotify:track:0jGw0a9GqeS6SzbBdScxof
Logical Song	2Copy	Classics	spotify:track:5ZynuAP8wUfziFZWgOZOY2
The Logical Song	Train Ride	Timeless Rock Hits Forever (Top 25 World Rock Hits)	spotify:track:6QFOLtfDh0Gx3swdttjKvN
The Logical Song	Panagiotis Margaris	Rock of My Soul	spotify:track:7GvpMlqLeQuxJ17Xudbu4u
The Logical Song	Aitana López	Alone	spotify:track:1zqs6r5HsgAMiiEX06FlBQ
The Logical Song	Mindless Self Indulgence	How I Learned to Stop Giving a Shit and Love Mindless Self Indulgence	spotify:track:7KhjExyVynSAP6PK8LZkBm

Me Skotose Giati Tin Agapousa – Stratos Dionisiou
Me Skotose Giati Tin Agapousa	Stratos Dionisiou	I Megaliteres Epitihies Tou	spotify:track:6ZOZPDFM5elwISXg2c2Wpb
Spasmena Kommatia Tis Kardias	Antonis Remos	Spasmena Kommatia Tis Kardias	spotify:track:2CIOdprH35qLe14Mvi3qMQ
Olos Dikos Sou	Antonis Remos	Spasmena Kommatia Tis Kardias	spotify:track:4Fz3gyqJZRB05ycBQZLHsO
Otan Se Rotisane	Antonis Remos	Otan Se Rotisane	spotify:track:15V49wyGJiCYkVQ4ys1bUt
Mi mou Les Antio - Live	Kostas Makedonas	Christos Nikolopoulos: My Life the Songs - Live at Athens Concert Hall in Greece	spotify:track:3cIXjaVsTvMcN1EZmAfnUU

Nalyssa Green
Κοκτέιλ	Nalyssa Green	Κοκτέιλ	spotify:track:57rmsIZTYZ6XU2KNvFpXio

Karlheinz Stockhausen – Stockhausen: Kurzwellen
Kurzwellen, Work No. 25, System 1 (Realization by Ensemble C.L.S.I.): Introduction Shortwave Radio Quartet	Karlheinz Stockhausen, Ensemble C.L.S.I., Paul Méfano	Stockhausen: Kurzwellen	spotify:track:5QXzQohzMuhAKGy93dTM6y
Kurzwellen, Work No. 25, System 1 (Realization by Ensemble C.L.S.I.): Introduction Instrumental Quartet	Karlheinz Stockhausen, Ensemble C.L.S.I., Paul Méfano	Stockhausen: Kurzwellen	spotify:track:39BII99sebeH7lvLi0RWM8
Kurzwellen, Work No. 25, System 1: First W Radio Solo, Followed by Instrumental Quartet [4 Synchronous Events]	Karlheinz Stockhausen, Ensemble C.L.S.I., Paul Méfano	Stockhausen: Kurzwellen	spotify:track:1ymppGAf501AD9Ji430eu6
Kurzwellen, Work No. 25, System 1: Radio Followed by Instrumental Trio [5 Synchronous Events]	Karlheinz Stockhausen, Ensemble C.L.S.I., Paul Méfano	Stockhausen: Kurzwellen	spotify:track:1iAe6GYzyn8w50KE7rNOsh
Kurzwellen, Work No. 25, System 1: Instrumental Duo [2 Alternating Events]	Karlheinz Stockhausen, Ensemble C.L.S.I., Paul Méfano	Stockhausen: Kurzwellen	spotify:track:5KRQrqpXFkzDQG1Ogmr36q
Kurzwellen, Work No. 25, System 1: Radio Followed by Instrumental Duo [1 Synchronous Event]	Karlheinz Stockhausen, Ensemble C.L.S.I., Paul Méfano	Stockhausen: Kurzwellen	spotify:track:4hVnhmS5OwCNRqL2m86AEk
Kurzwellen, Work No. 25, System 1: Second W Radio Solo Followed by Instrumental quartet [2 Synchronous Events]	Karlheinz Stockhausen, Ensemble C.L.S.I., Paul Méfano	Stockhausen: Kurzwellen	spotify:track:6bHI3k5IylSBe9l5U6Mhuq
Kurzwellen, Work No. 25, System 1: Radio Followed by Instrumental Quartet [5 Synchronous Events]	Karlheinz Stockhausen, Ensemble C.L.S.I., Paul Méfano	Stockhausen: Kurzwellen	spotify:track:7MDSHv11n69AmCNHkYYFTw
Kurzwellen, Work No. 25, System 2: Beginning of System Event Followed by Instrumental Quartet [1 Alternating Event]	Karlheinz Stockhausen, Ensemble C.L.S.I., Paul Méfano	Stockhausen: Kurzwellen	spotify:track:1bPQ3YB24LuCys7mQdCDgl
Kurzwellen, Work No. 25, System 2: Instrumental Duo [1 Alternating Event]	Karlheinz Stockhausen, Ensemble C.L.S.I., Paul Méfano	Stockhausen: Kurzwellen	spotify:track:0ioP7g0ZemAXEsRobolPDS
Kurzwellen, Work No. 25, System 2: Radio Followed by Instrumental Duo [4 Synchronous Events]	Karlheinz Stockhausen, Ensemble C.L.S.I., Paul Méfano	Stockhausen: Kurzwellen	spotify:track:2QI2poIrO7gZHZzfW0rLzA
Kurzwellen, Work No. 25, System 2: Radio Followed by Instrumental Duo [5 Synchronous Events]	Karlheinz Stockhausen, Ensemble C.L.S.I., Paul Méfano	Stockhausen: Kurzwellen	spotify:track:7mGG13PtSfJOBYs7Kq4rxp
Kurzwellen, Work No. 25, System 2: Third W Radio Solo Followed by Instrumental quartet [3 Synchronous Events]	Karlheinz Stockhausen, Ensemble C.L.S.I., Paul Méfano	Stockhausen: Kurzwellen	spotify:track:1r45qyua6ANsRNWqn15fNv
Kurzwellen, Work No. 25, System 2: Radio Followed by Instrumental Duo [2 Synchronous Events]	Karlheinz Stockhausen, Ensemble C.L.S.I., Paul Méfano	Stockhausen: Kurzwellen	spotify:track:4i8J2nvPUWGlmvQ0wXfEHU
Kurzwellen, Work No. 25, System 2: Radio Followed by Instrumental Duo [3 Synchronous Events]	Karlheinz Stockhausen, Ensemble C.L.S.I., Paul Méfano	Stockhausen: Kurzwellen	spotify:track:4ihN74S4dByKyNKVcSt7nb
Kurzwellen, Work No. 25, System 3: Instrumental Trio [5 Alternating Events]	Karlheinz Stockhausen, Ensemble C.L.S.I., Paul Méfano	Stockhausen: Kurzwellen	spotify:track:3OCKZ7QnpMDCkXg6HF1dir
Kurzwellen, Work No. 25, System 3: Radio Followed by Instrumental Trio [1 Synchronous Event]	Karlheinz Stockhausen, Ensemble C.L.S.I., Paul Méfano	Stockhausen: Kurzwellen	spotify:track:3BqKDdi2elGRnMre33cwOe
Kurzwellen, Work No. 25, System 3: Radio Followed by Instrumental Trio [3 Synchronous Events]	Karlheinz Stockhausen, Ensemble C.L.S.I., Paul Méfano	Stockhausen: Kurzwellen	spotify:track:7DSwaZOZ48NPXJCQwwyXio
Kurzwellen, Work No. 25, System 3: Fourth W Radio Solo Followed by Instrumental Quartet [5 Synchronous Events]	Karlheinz Stockhausen, Ensemble C.L.S.I., Paul Méfano	Stockhausen: Kurzwellen	spotify:track:3H18DFFopFg8msTBSEBQZM
Kurzwellen, Work No. 25, System 3: Radio Followed by Instrumental Trio [2 Synchronous Events]	Karlheinz Stockhausen, Ensemble C.L.S.I., Paul Méfano	Stockhausen: Kurzwellen	spotify:track:2yyCCt171jFN52qsZdRG56
Kurzwellen, Work No. 25, System 3: Instrumental Duo [5 Alternating Events]	Karlheinz Stockhausen, Ensemble C.L.S.I., Paul Méfano	Stockhausen: Kurzwellen	spotify:track:0rvpgdo5EdtRwsNTwV3pq0
Kurzwellen, Work No. 25, System 3: Instrumental Trio [4 Alternating Events]	Karlheinz Stockhausen, Ensemble C.L.S.I., Paul Méfano	Stockhausen: Kurzwellen	spotify:track:1pzExbKRohaZ5o8fQpodHN
Kurzwellen, Work No. 25, System 4: Instrumental Quartet [4 Alternating Events]	Karlheinz Stockhausen, Ensemble C.L.S.I., Paul Méfano	Stockhausen: Kurzwellen	spotify:track:5kxiJehKwh3N9VH6OHuVE2
Kurzwellen, Work No. 25, System 4: Instrumental Duo [1 Alternating Event]	Karlheinz Stockhausen, Ensemble C.L.S.I., Paul Méfano	Stockhausen: Kurzwellen	spotify:track:4VsmRCNLUCV31tJaBl0vGV
Kurzwellen, Work No. 25, System 4: Instrumental Trio [3 Alternating Events]	Karlheinz Stockhausen, Ensemble C.L.S.I., Paul Méfano	Stockhausen: Kurzwellen	spotify:track:2lgiYunUtgY5KYsmOYxtOm
Kurzwellen, Work No. 25, System 4: Radio Followed by Instrumental Trio [6 Synchronous Events]	Karlheinz Stockhausen, Ensemble C.L.S.I., Paul Méfano	Stockhausen: Kurzwellen	spotify:track:14YljGjBLiMvqA8D8THbY0
Kurzwellen, Work No. 25, System 4: Instrumental Duo [2 Alternating Events]	Karlheinz Stockhausen, Ensemble C.L.S.I., Paul Méfano	Stockhausen: Kurzwellen	spotify:track:38YlwxpzVQlshCs3UoZCee
Kurzwellen, Work No. 25, System 4: Instrumental Quartet [3 Alternating Events]	Karlheinz Stockhausen, Ensemble C.L.S.I., Paul Méfano	Stockhausen: Kurzwellen	spotify:track:0ATBMuzcFXMW1oHZTYZnMh
Kurzwellen, Work No. 25, System 4: Instrumental Duo [4 Alternating Events]	Karlheinz Stockhausen, Ensemble C.L.S.I., Paul Méfano	Stockhausen: Kurzwellen	spotify:track:1mrKWDEtzFiyAAdqsEyhyD
Kurzwellen, Work No. 25, System 4: Radio Followed by Instrumental Duo [2 Synchronous Events]	Karlheinz Stockhausen, Ensemble C.L.S.I., Paul Méfano	Stockhausen: Kurzwellen	spotify:track:4x8iaLknRi2bVunDu2g8vT
Kurzwellen, Work No. 25, System 4: Instrumental & Radio Trio [1 Alternating Event]	Karlheinz Stockhausen, Ensemble C.L.S.I., Paul Méfano	Stockhausen: Kurzwellen	spotify:track:7n3yIQgcaye3vtUGcp3qiM

Stomp! – The Brothers Johnson
Stomp!	The Brothers Johnson	Light Up The Night	spotify:track:6VZdUa8JjaGF2LGsiRG9lC
Give Me the Night	George Benson	Give Me the Night	spotify:track:5gaUkg5JNk8c4mr2jnpX8H
Can't Fake the Feeling	Geraldine Hunt	Can't Fake the Feeling	spotify:track:3WtL910PEMIjJkkpM4xMKU
Can You Feel the Force	The Real Thing	Can You Feel the Force - All Their Biggest Hits!	spotify:track:3qHyAs8V2REO9HnooNWF71
Too Hot	Kool & The Gang	The Very Best Of Kool & The Gang (Reissue)	spotify:track:1S3RMWe23mYX6h3fevsgDq
Vertigo / Relight My Fire	Dan Hartman	Relight My Fire	spotify:track:2zQHhhk8MovP9H3LZMQvXa
Walk On By	D-Train	The Best of D Train	spotify:track:4tSWqJXwWNSzToz3DFtMU8
I.O.U. - (Remastered)	Freeez	Gonna Get You (Expanded Edition) [Remastered]	spotify:track:2WzsQlzQuaQnS7yRAtCMB8
I Got My Mind Made Up (You Can Get It Girl) - 12" Dance Mix	Instant Funk	Instant Funk	spotify:track:3dtmW81IL7oyBfzflog6c1
Shame - 12" Disco Mix	Evelyn "Champagne" King	The Essential Evelyn "Champagne" King	spotify:track:0QewO59ixTHz3bsa4mRHup

Go-thru--shoegaze
Climactic Phase No.3	Seefeel	Quique	spotify:track:1m1cOm0d6M5slDsfcFoMw9
Industrious	Seefeel	Quique	spotify:track:0Qr2qYjBbPEd3mwulFTqF4
Imperial	Seefeel	Quique	spotify:track:4zMJqWm0JxbFJRIZ0VVKmb
Plainsong	Seefeel	Quique	spotify:track:7bBJssMh23U5lkaHtuoeGb
Charlotte's Mouth	Seefeel	Quique	spotify:track:3lDZ7YSrmfemUho7hDzOdA
Through You	Seefeel	Quique	spotify:track:3YgHCiHCxXGTKzaq8CgKfG
Filter Dub	Seefeel	Quique	spotify:track:7v2JERuH6WDt2veWbRo1AY
Signals	Seefeel	Quique	spotify:track:0FTXHtgwMLJ3OUZ0VDolZp
Girl On A Motorbike	Swervedriver	Mezcal Head	spotify:track:57syaAPsUhU4Kyte6IBaM8
Duress	Swervedriver	Mezcal Head	spotify:track:2ZRZS8CadUNoQSs9k2DdWH
You Find It Everywhere	Swervedriver	Mezcal Head	spotify:track:6FE62Fj06ac3DwiUmD6hKM
Never Lose That Feeling/Never Learn	Swervedriver	Mezcal Head	spotify:track:6V0aCjUMxvBPGJkesZjxvj
He Holds Her, He Needs Her	Kitchens Of Distinction	Strange Free World	spotify:track:1Gwur0PBHXUppScrd6wwfZ
Polariods	Kitchens Of Distinction	Strange Free World	spotify:track:3icwY4A4PFI1CNxvTdZ4mG
Gorgeous Love	Kitchens Of Distinction	Strange Free World	spotify:track:5HLwCy2SkQEiBUNYQO0HjC
Aspray	Kitchens Of Distinction	Strange Free World	spotify:track:5qP6nBNEslzvEQp1TBPVFD
Drive That Fast	Kitchens Of Distinction	Strange Free World	spotify:track:14lrMBmpivkvPXSnKvfkJ3
Within the Daze of Passion	Kitchens Of Distinction	Strange Free World	spotify:track:59da8nqpsASuLffE5tcpi1
Under the Sky, Inside the Sea	Kitchens Of Distinction	Strange Free World	spotify:track:0tpRKwdiw3K12EL7ZysDTv
Desire Lines	Lush	Split	spotify:track:63JP68VirmCXtWRoMTX8Xi
The Invisible Man	Lush	Split	spotify:track:0WUnQPjtGVVXkYegXc4dxV
Undertow	Lush	Split	spotify:track:0DQcCxwiT5jQ9cFl3lrhFv
Never-Never	Lush	Split	spotify:track:4Mkavihor6pZV0m1x85gnu
Lit Up	Lush	Split	spotify:track:0D3C2gOk2qSMWGJLSobQpK
Starlust	Lush	Split	spotify:track:6jTKbWPD3NznzQyHv10cLK
When I Die	Lush	Split	spotify:track:6KgSyHivrEOBpvt9DjeMhs
When Will You Come Home	Galaxie 500	On Fire	spotify:track:2m4pMnVi3e9HuSwSci6dg8
Decomposing Trees	Galaxie 500	On Fire	spotify:track:6XzwamNZckFVqq1zw3DHT4
Another Day	Galaxie 500	On Fire	spotify:track:1z4gr7jbB0WneRxX2teFiA
Leave the Planet	Galaxie 500	On Fire	spotify:track:7gTJKeer3CrhBXMfh6ZO0y
Plastic Bird	Galaxie 500	On Fire	spotify:track:1at3n20c5mRAFfNKD1Ru7j
Isn't It A Pity	Galaxie 500	On Fire	spotify:track:4JyGEgUGVkiszOv2caAYlm
Victory Garden	Galaxie 500	On Fire	spotify:track:3HWfEc16Y511NR8yRwVSh6
Ceremony	Galaxie 500	On Fire	spotify:track:2x3QOPnAfn57SFG8EOafDm
Cold Night	Galaxie 500	On Fire	spotify:track:77Thdu78QWOK6OAnX5fSlK
Sweetness and Light	Lush	Gala	spotify:track:577LINEVunl9HDxC4vxuAx
Sunbathing	Lush	Gala	spotify:track:4tsteRyfqzTrLMiFDlIJhA
Breeze	Lush	Gala	spotify:track:3bzPeNnkDTzXFSTxrSHpVV
De-Luxe	Lush	Gala	spotify:track:5aUCwet7abFYrClJNtZ2hO
Leaves Me Cold	Lush	Gala	spotify:track:55SuzmHZVSBOiGSHXWL3QG
Downer	Lush	Gala	spotify:track:2ezUo1LTTov8ql7gpaL5dF
Thoughtforms - 2nd Version	Lush	Gala	spotify:track:7ARIbfiiJA4nyuXyXsGxJL
Baby Talk	Lush	Gala	spotify:track:2Xp13rqih9w9hBceyRHRpc
Thoughtforms	Lush	Gala	spotify:track:1wWU1F0Lhu9x2geX2h4L0x
Scarlet	Lush	Gala	spotify:track:7tuRY10SatGBp3wRu6jusU
Bitter	Lush	Gala	spotify:track:4taZYuVqS3UcjVaJwoT5kD
Second Sight	Lush	Gala	spotify:track:4l9fMz6MrDCVLFucfo963d
Etheriel	Lush	Gala	spotify:track:0TPwU1vgNoTaHo1OMH0oc5
Hey Hey Helen	Lush	Gala	spotify:track:6K7JkDuQgX8S2XD5qScYRQ
Scarlet - Long Version	Lush	Gala	spotify:track:6fb7EkOyYHa7KvqUqkiZEB
Stray	Lush	Spooky	spotify:track:1eDB2CzHBBAAH1neiqoxiQ
Nothing Natural	Lush	Spooky	spotify:track:1KSxuruk0aplDMmnbTpsw9
Tiny Smiles	Lush	Spooky	spotify:track:2Id2UKDFAwy73LcYLcY3oh
Covert	Lush	Spooky	spotify:track:0DTlTVAJuz6se3C5jB4Y9Y
Ocean	Lush	Spooky	spotify:track:6vfLGN7ZmkSpuULF5rT4Z6
For Love	Lush	Spooky	spotify:track:3o2T5viqXW9uPGmgU0VdB7
Superblast!	Lush	Spooky	spotify:track:1NIhKTlzX3JaUTQvGIAr7I
Untogether	Lush	Spooky	spotify:track:29Y1LODDL7AEVWpzqkQKxk
Fantasy	Lush	Spooky	spotify:track:3MdChFeeKT4HXX0HNlWKvy
Take	Lush	Spooky	spotify:track:1KpUkjU2tKU7fG2CTe1mnP
Laura	Lush	Spooky	spotify:track:65swp1NvJlTpVEaiI1wcL5
Monochrome	Lush	Spooky	spotify:track:51T9zCeXS7Mk6kUjrgGBzW
Curse words	A Sunny Day In Glasgow	Ashes Grammar	spotify:track:5UR0MQYHSkeZAJajaOCYAP
Close chorus	A Sunny Day In Glasgow	Ashes Grammar	spotify:track:6EbRp0XV1fxtjOxrvS9HPQ
Shy	A Sunny Day In Glasgow	Ashes Grammar	spotify:track:7CEmvOrMOUXFUzYhktGCsH
Lights	A Sunny Day In Glasgow	Ashes Grammar	spotify:track:0HWrwYGCbP5HMrXa4alNDQ
Passionate introverts (Dinosaurs)	A Sunny Day In Glasgow	Ashes Grammar	spotify:track:3fIw0YSt6Pv5zJRlaZxCNJ
West Philly vocoder	A Sunny Day In Glasgow	Ashes Grammar	spotify:track:5rxGZqz4p33ykce03NgtBI
Evil, with evil, against evil	A Sunny Day In Glasgow	Ashes Grammar	spotify:track:240oIJsEx2qsfUVAFwnqxK
The white witch	A Sunny Day In Glasgow	Ashes Grammar	spotify:track:3GsD0oUarKc8XJZ3zf9ees
Nitetime rainbows	A Sunny Day In Glasgow	Ashes Grammar	spotify:track:0JwRzQKerAANoU6ZrgmJWk
Canalfish	A Sunny Day In Glasgow	Ashes Grammar	spotify:track:0eNlAJwlwuBYO2eieMWLVv
Loudly	A Sunny Day In Glasgow	Ashes Grammar	spotify:track:5aKjnuMmYaTc3JLd5VNcdp
Blood white	A Sunny Day In Glasgow	Ashes Grammar	spotify:track:03v3pOI5YRg3UHhWYFTEFD
Ashes grammar	A Sunny Day In Glasgow	Ashes Grammar	spotify:track:6DsP2ZFk1P5A03qEqJWytH
Ashes maths	A Sunny Day In Glasgow	Ashes Grammar	spotify:track:5NoiZDNiCs6DgHIafpMLOh
Miss my friends	A Sunny Day In Glasgow	Ashes Grammar	spotify:track:1Buhek8qgsSG61hiHaffzj
Starting at a disadvantage	A Sunny Day In Glasgow	Ashes Grammar	spotify:track:0dPt8UGsGx8n4jTbpiq7mB
Life's great	A Sunny Day In Glasgow	Ashes Grammar	spotify:track:1EYkcm7rGvC9owADCsve6d
Headphone space	A Sunny Day In Glasgow	Ashes Grammar	spotify:track:46t9Vphm7FrHNKoxnxohzj
Sci-Flyer	Swervedriver	Raise	spotify:track:1ORg32aLOabOcCdVswP2xt
Pile-Up	Swervedriver	Raise	spotify:track:5s8uFKUi6ajvH52V5Aytyp
Son Of Mustang Ford	Swervedriver	Raise	spotify:track:3wgN7w9we5a5fJt1bg0H3a
Deep Seat	Swervedriver	Raise	spotify:track:5H2kNIrzEsKfofmrt1B3SU
Rave Down	Swervedriver	Raise	spotify:track:11MgD2LnjAig9KtK0ePJtj
Sunset	Swervedriver	Raise	spotify:track:6Tv58KVeihCIXI4E4XIrpl
Feel So Real	Swervedriver	Raise	spotify:track:02iVuWRDXilF6nc2yb1skL
Sandblasted	Swervedriver	Raise	spotify:track:1AsHoIEYuaTm8F3X0MMwU0
Lead Me Where You Dare...	Swervedriver	Raise	spotify:track:61OVzZbWLkvsaLBKkoMtFu
Just Like Honey	The Jesus and Mary Chain	Psychocandy	spotify:track:4E6YM4V7Kz6zpbiNsliwEl
The Living End	The Jesus and Mary Chain	Psychocandy	spotify:track:3xg4YGdLrf7lfZv0GBKbHf
Taste the Floor	The Jesus and Mary Chain	Psychocandy	spotify:track:7DwSIfvDNZo4RslGgQNzmw
The Hardest Walk	The Jesus and Mary Chain	Psychocandy	spotify:track:70kEZ0IwNmLf0vxQ7EzGCg
Cut Dead	The Jesus and Mary Chain	Psychocandy	spotify:track:71ipVnuH2x4QCIjfvNYQCB
In a Hole	The Jesus and Mary Chain	Psychocandy	spotify:track:30CB7otbptPUIRCB68nW1f
Taste of Cindy	The Jesus and Mary Chain	Psychocandy	spotify:track:2CFbsphaLiAoayu8nMfCwf
Never Understand	The Jesus and Mary Chain	Psychocandy	spotify:track:3tArKAiS8FGNpU9q3H2Iba
Inside Me	The Jesus and Mary Chain	Psychocandy	spotify:track:0G4vmlGLm7Jw1Y5Vu9kN4e
Sowing Seeds	The Jesus and Mary Chain	Psychocandy	spotify:track:3Xq90u65Zjd8U5oZBvhCsx
My Little Underground	The Jesus and Mary Chain	Psychocandy	spotify:track:4wTHhf4uK520pPZymrHa2G
You Trip Me Up	The Jesus and Mary Chain	Psychocandy	spotify:track:2FODdpnPyXL6lieLuH6JKs
Something's Wrong	The Jesus and Mary Chain	Psychocandy	spotify:track:2PYEXCDGOg4xhWnSVdObti
It's So Hard	The Jesus and Mary Chain	Psychocandy	spotify:track:1f5kATU6mFl7xicJ6Pogro
Untitled	Swirlies	Blonder Tongue Audio Baton	spotify:track:0VsjkAEkZvaUoDt0PAzJxC
Bell	Swirlies	Blonder Tongue Audio Baton	spotify:track:2bUin4VC1LNdF8Bjjxb8Uc
Vigilant Always	Swirlies	Blonder Tongue Audio Baton	spotify:track:0XnD3JH2YkWRAZ3cKEVY0s
His Love Just Washed Away	Swirlies	Blonder Tongue Audio Baton	spotify:track:3q0c9gm7FORbHbhRtnXQvL
His Life Of Academic Freedom	Swirlies	Blonder Tongue Audio Baton	spotify:track:6F8b45lXCoVey4yRFKD6kH
Pancake	Swirlies	Blonder Tongue Audio Baton	spotify:track:00YCRrySf0dJ6nRCKYSAkA
Jeremy Parker	Swirlies	Blonder Tongue Audio Baton	spotify:track:0pVgFjjojISSczzmj66FTA
Park The Car By The Side Of The Road	Swirlies	Blonder Tongue Audio Baton	spotify:track:346misamqyQbR2HUSYRrk6
Tree Chopped Down	Swirlies	Blonder Tongue Audio Baton	spotify:track:43Cuq1oySxtT7CKymYxpMz
Wrong Tube	Swirlies	Blonder Tongue Audio Baton	spotify:track:5DWaUCipAPsEQEYNyQF2H1
Wait Forever	Swirlies	Blonder Tongue Audio Baton	spotify:track:0eptKHse0Nyw7RTb1kKHSn
Way the World Is - Remastered	Pale Saints	The Comforts of Madness (30th Anniversary Reissue)	spotify:track:6YXnCHAUxqUlkaRfB4hKb5
You Tear the World in Two - Remastered	Pale Saints	The Comforts of Madness (30th Anniversary Reissue)	spotify:track:25Hy4OvXxAfcxGZ0aagkeb
Sea of Sound - Remastered	Pale Saints	The Comforts of Madness (30th Anniversary Reissue)	spotify:track:55xAdhjJzxTWJZLybqPEIw
True Coming Dream - Remastered	Pale Saints	The Comforts of Madness (30th Anniversary Reissue)	spotify:track:3cmtzxOK0OCbSsda6Tz30k
Little Hammer - Remastered	Pale Saints	The Comforts of Madness (30th Anniversary Reissue)	spotify:track:66cRMGVk9GnkCtd1Ba06LY
Insubstantial - Remastered	Pale Saints	The Comforts of Madness (30th Anniversary Reissue)	spotify:track:3VPgK80s1SnQu6fhWOFcvn
A Deep Sleep for Steven - Remastered	Pale Saints	The Comforts of Madness (30th Anniversary Reissue)	spotify:track:5AfBdhWLcZnn03vG30T1Ib
Language of Flowers - Remastered	Pale Saints	The Comforts of Madness (30th Anniversary Reissue)	spotify:track:74LSFxjTWhNjePKRCiTuqg
Fell from the Sun - Remastered	Pale Saints	The Comforts of Madness (30th Anniversary Reissue)	spotify:track:1mtg35wFPVBCR9UFZnIdBq
Sight of You - Remastered	Pale Saints	The Comforts of Madness (30th Anniversary Reissue)	spotify:track:6Ka1pHccAVExsJpoZed3Zb
Time Thief - Remastered	Pale Saints	The Comforts of Madness (30th Anniversary Reissue)	spotify:track:3IIZXG5tdx2U1oaoduyW1t
Birds	M83	Dead Cities, Red Seas & Lost Ghosts	spotify:track:4qrv4KMBrGVcaN5NU1TSlF
Unrecorded	M83	Dead Cities, Red Seas & Lost Ghosts	spotify:track:76nhugKSN7SY54MA1HCm80
Run Into Flowers	M83	Dead Cities, Red Seas & Lost Ghosts	spotify:track:5Y8sPOwWupGEGM7ifBDR7F
In church	M83	Dead Cities, Red Seas & Lost Ghosts	spotify:track:6ppk0JDGDaRnXHqkZM16Kb
America	M83	Dead Cities, Red Seas & Lost Ghosts	spotify:track:0gSOZ2CH1PJXPraaS3NGZo
On a white lake, near a green mountain	M83	Dead Cities, Red Seas & Lost Ghosts	spotify:track:1tDLEdfntclNJREBZ5STmi
Noise	M83	Dead Cities, Red Seas & Lost Ghosts	spotify:track:73khodcc65mVNpUSJNovnR
Be wild	M83	Dead Cities, Red Seas & Lost Ghosts	spotify:track:0hH2MFhI2WZsdmrhzWe8u2
Cyborg	M83	Dead Cities, Red Seas & Lost Ghosts	spotify:track:2zHLZdGaOnk7A6CdZaVA1R
0078h	M83	Dead Cities, Red Seas & Lost Ghosts	spotify:track:4oBR1uJMuM2PDPRc1VZRi3
Gone	M83	Dead Cities, Red Seas & Lost Ghosts	spotify:track:4PzbfknNNtP82NyAz75ixa
Beauties can die	M83	Dead Cities, Red Seas & Lost Ghosts	spotify:track:3PyDdkze6ZoVylcGqJPM32
Missing You	A Place To Bury Strangers	A Place to Bury Strangers	spotify:track:6r5eQSkDYxXV5o4aOHiGxz
Don't Think Lover	A Place To Bury Strangers	A Place to Bury Strangers	spotify:track:4KpnRLjQSWAQbHiysIdfqc
To Fix the Gash in Your Head	A Place To Bury Strangers	A Place to Bury Strangers	spotify:track:3iTEYeYv1zUc3H9Uoeldp8
The Falling Sun	A Place To Bury Strangers	A Place to Bury Strangers	spotify:track:44JNY2SRAtoZJOj8R4TgtH
Another Step Away	A Place To Bury Strangers	A Place to Bury Strangers	spotify:track:7dBrtQhB1608hyME1768yG
Breathe	A Place To Bury Strangers	A Place to Bury Strangers	spotify:track:6jka3HesKacbUaWJXig6FG
I Know I'll See You	A Place To Bury Strangers	A Place to Bury Strangers	spotify:track:0Rv8PYeNvrgikGXTJGGgzv
She Dies	A Place To Bury Strangers	A Place to Bury Strangers	spotify:track:5JvnX0DGhb4N9YVM3EL0Kt
My Weakness	A Place To Bury Strangers	A Place to Bury Strangers	spotify:track:0JpA2IbwC7rvt74E6Zb2u9
Ocean	A Place To Bury Strangers	A Place to Bury Strangers	spotify:track:4aJtun2GlBAgIFWjD0cSkq
Too Soon	The Radio Dept.	Lesser Matters	spotify:track:2lbxVgRdGVVqp82c1PtQkM
Where Damage Isn't Already Done	The Radio Dept.	Lesser Matters	spotify:track:0K32TGPP1Fj7YGPgw7pmgA
Keen on Boys	The Radio Dept.	Lesser Matters	spotify:track:0W0yCV0lijjYdyt4fs1DdH
Why Won't You Talk About It	The Radio Dept.	Lesser Matters	spotify:track:3hYJBGfILiHac6fohFR0ps
It's Been Eight Years	The Radio Dept.	Lesser Matters	spotify:track:0kkvBRXkyGvWlMeW4Bpipm
Bus	The Radio Dept.	Lesser Matters	spotify:track:6amfZoZwnLrcVamOOKDQDO
Slottet #2	The Radio Dept.	Lesser Matters	spotify:track:71qOWCP4mL5JSnhZEjNS3L
1995	The Radio Dept.	Lesser Matters	spotify:track:2AvRQCQ9NtOFes1jQM00SC
Against the Tide	The Radio Dept.	Lesser Matters	spotify:track:7wVyuJtCrxqoltyyyWfANl
Strange Things Will Happen	The Radio Dept.	Lesser Matters	spotify:track:6rbTHxFbBn5JjNw2aYffop
Your Father	The Radio Dept.	Lesser Matters	spotify:track:6TbfMFOx0RqEu24qfgZsxL
Ewan	The Radio Dept.	Lesser Matters	spotify:track:5x84ouFIA6tLS5DHti4iDD
Lost and Found	The Radio Dept.	Lesser Matters	spotify:track:4jHKUvystxaILtas0Jowca
You Know It's True	Spiritualized	Lazer Guided Melodies	spotify:track:26MwkxhOPFY9Qhr3xfwAVn
If I Were With Her Now	Spiritualized	Lazer Guided Melodies	spotify:track:7gDSPI26VsOIgcXKRc8V3C
I Want You	Spiritualized	Lazer Guided Melodies	spotify:track:30V8jILgWHdSPwajNUSGZb
Run	Spiritualized	Lazer Guided Melodies	spotify:track:5J7n40DXS04LEdnHdl1Fvg
Smiles	Spiritualized	Lazer Guided Melodies	spotify:track:3DowhSdFf46boTqXR4XD9P
Step Into the Breeze	Spiritualized	Lazer Guided Melodies	spotify:track:1enxcVkpdjGPcqnF8DAp6Y
Symphony Space	Spiritualized	Lazer Guided Melodies	spotify:track:5UMTiqwSUzQLEKpnbPf4Yb
Take Your Time	Spiritualized	Lazer Guided Melodies	spotify:track:5ZmTefWEhgHdZUlSYTyeXz
Shine a Light	Spiritualized	Lazer Guided Melodies	spotify:track:4PoTRZnQhOMJM9VMIS2pVh
Angel Sigh	Spiritualized	Lazer Guided Melodies	spotify:track:0VQhjFnHVICUnlG9RSWsh3
Sway	Spiritualized	Lazer Guided Melodies	spotify:track:5l9K6iRM2wfqPATjO3N0qQ
200 Bars	Spiritualized	Lazer Guided Melodies	spotify:track:2MldNla4TVFEhf5TVefGdG
Forever	Leave the Planet	Nowhere	spotify:track:7zTkKCqiFMqXfBKcmlMDgQ
Sirius B	Leave the Planet	Nowhere	spotify:track:277WLRpqPWweqN7AdIniiC
White Astra	Leave the Planet	Nowhere	spotify:track:1vrfDQ8g8I3PVbKgUGhk7U
Surrender	Leave the Planet	Nowhere	spotify:track:3tReSRWbwfsW9IG6Mbh9rH
Seashore	Leave the Planet	Nowhere	spotify:track:6st6yP7fY6mcF9gTRZdvwb
Desert Son	Leave the Planet	Nowhere	spotify:track:2PaIdVLUvoetIBE4J4vPbY
Heaven	LSD and the Search for God	Heaven Is a Place	spotify:track:1La3oTBpUJztVxuwiPnjjj
(I Don't Think That We Should) Take It Slow	LSD and the Search for God	Heaven Is a Place	spotify:track:1LFeDBh2XrZkMsaqj8Wvic
Outer Space (Long Way Home)	LSD and the Search for God	Heaven Is a Place	spotify:track:5ZPYl1m0Pxa1inezlk0vEx
Elizabeth	LSD and the Search for God	Heaven Is a Place	spotify:track:6TPu8KKaBlzvmZslmjJXzR
Without You	LSD and the Search for God	Heaven Is a Place	spotify:track:2iSwDr3uBmoDCvkpwSqcZf
Into the Deep Time (One Sun)	Candy Claws	Ceres & Calypso in the Deep Time	spotify:track:0lw2mLzNcwftfTvDojdySG
White Seal (Shell & Spine)	Candy Claws	Ceres & Calypso in the Deep Time	spotify:track:6XlfaXvDM55hr5wctH2mNd
Fell in Love (At the Water)	Candy Claws	Ceres & Calypso in the Deep Time	spotify:track:7qgVP1RmTu8Kg3MGsIl87D
Pangaea Girls (Magic Feeling)	Candy Claws	Ceres & Calypso in the Deep Time	spotify:track:49DmTlbizOa1VTQRqVAuWJ
New Forest (Five Heads of the Sun)	Candy Claws	Ceres & Calypso in the Deep Time	spotify:track:1igCqwHc4LMwLh7JI53Zx8
Transitional Bird (Clever Girl)	Candy Claws	Ceres & Calypso in the Deep Time	spotify:track:42UEtDZUSpcCOWtmdBPccJ
Charade (Fern Prairie)	Candy Claws	Ceres & Calypso in the Deep Time	spotify:track:4TZCgYaoOkM4lJf26BVK8D
Fallen Tree Bridge (Brave Rainbow Rider)	Candy Claws	Ceres & Calypso in the Deep Time	spotify:track:3GSfVEFVJCTvtxF0UUzdIr
Birth of the Flower (Seagreen)	Candy Claws	Ceres & Calypso in the Deep Time	spotify:track:0MjmarACqIH451S26Wfpuw
Illusion (Fern Lake)	Candy Claws	Ceres & Calypso in the Deep Time	spotify:track:74ctB0ufdAY69TDN9J18V9
Night Ela (Mystic Thing)	Candy Claws	Ceres & Calypso in the Deep Time	spotify:track:2w2WdQb59ERxKh25nFjyAx
Where I Found You (One Star)	Candy Claws	Ceres & Calypso in the Deep Time	spotify:track:1o3amYz7RPk7OpVLbarVcQ
Drag	Bethany Curve	Gold	spotify:track:4g9PMHhRKsP9xjgrgq047b
Temporary	Bethany Curve	Gold	spotify:track:5nVOYerVFur57q3TQctHQe
Carnyval Sweet	Bethany Curve	Gold	spotify:track:7HM5xdGirYfNAV64qRtrhM
Fold In The Floor	Bethany Curve	Gold	spotify:track:6h8wlj5xF97Ur9gGXeNOPT
Fourteen	Bethany Curve	Gold	spotify:track:1TBSk75p6FilkkIuNk2jTI
Pool And The Shine	Bethany Curve	Gold	spotify:track:2FOLKk63MKddc9GB4Oh8P7
Strength	Bethany Curve	Gold	spotify:track:4myQzqB7OF0xOutPTuQ873
Cygnus X-1	Bethany Curve	Gold	spotify:track:6M2uBzYyTFtjLBNuzyXQF6
Movement	Bethany Curve	Gold	spotify:track:5GhFos8m6czkCIMUOV27UV
Marasmus	Bethany Curve	Gold	spotify:track:1sjbaXwQJKOMjzaPNasHji
sugaredglowing	Lovesliescrushing	bloweyelashwish	spotify:track:5Rs6mLmuT6af3Wqm59gqQp
glimmer	Lovesliescrushing	bloweyelashwish	spotify:track:0LuYnocf8k20r1Dpt9aokj
youreyesimmaculate	Lovesliescrushing	bloweyelashwish	spotify:track:6AAHrly84tTY3hVufCByxr
crushing	Lovesliescrushing	bloweyelashwish	spotify:track:6TJhhn5pa0w7uQiFYPirMy
bloweyelashwish	Lovesliescrushing	bloweyelashwish	spotify:track:7FI91v4tXCD1zurC2Y8B76
precious	Lovesliescrushing	bloweyelashwish	spotify:track:26XXxy2E6RueNKEu46j1GT
darkglassdloieyes	Lovesliescrushing	bloweyelashwish	spotify:track:2Orav0S8nebr4aOgbKXXjy
finger	Lovesliescrushing	bloweyelashwish	spotify:track:0KoglPn1GVd8kD3ghndUmU
halo	Lovesliescrushing	bloweyelashwish	spotify:track:2xfy66cc1pwdNRGAb1J6L9
Valerian (her voice honeyed)	Lovesliescrushing	xuvetyn	spotify:track:2kMIvpGaR9R029KX6CTIci
Aquan 1	Lovesliescrushing	xuvetyn	spotify:track:2lbWL5p5WwAND8NqHWuDSa
Mandragora Louvareen	Lovesliescrushing	xuvetyn	spotify:track:5DikJZ9nKDXiVDj6NbsQ69
Staticburst	Lovesliescrushing	xuvetyn	spotify:track:6rDHR8eUJIDg1N4Vi8Y7Wc
Xarella Almandyne	Lovesliescrushing	xuvetyn	spotify:track:7aLL8FU7nqe7rdmAbzED9j
Milkysoft	Lovesliescrushing	xuvetyn	spotify:track:2EZI8bQOdwMR1klFjwcbAI
Blooded and Blossom-blown	Lovesliescrushing	xuvetyn	spotify:track:15x9WXAz8YHrGfibgsirdN
Hum Vibralux	Lovesliescrushing	xuvetyn	spotify:track:4gtMsSxNUboJRj8wkYVc6d
Virgin Blue-eyed	Lovesliescrushing	xuvetyn	spotify:track:7A09SRoM8ErwxjIWmRxcIo
Seesaw	Lovesliescrushing	xuvetyn	spotify:track:75fNJrT5bhYUeMELTrHD8G
Flowered Smother	Lovesliescrushing	xuvetyn	spotify:track:2wDReD0jwzW0hWNjmClz7B
Monar	Lovesliescrushing	xuvetyn	spotify:track:5Y8Ww8EMRVBgwUhLw5vvZr
Silver (fairy threaded)	Lovesliescrushing	xuvetyn	spotify:track:1Bq7QT2SU29sxMV7P1ZrBd
Luma (Web-Like and Crescent)	Lovesliescrushing	xuvetyn	spotify:track:3czqk9VwkyGSFfvCMSSoMQ
Golden-handed	Lovesliescrushing	xuvetyn	spotify:track:6PI7G14AzotoHEN3vbaHDu
Bones of Angels: a. Bronze Lit Feathers; b. Her Tongue Pulled Out	Lovesliescrushing	xuvetyn	spotify:track:0OTux5WJFkRePKaqiQgi3y
Ghosts That Swirl	Lovesliescrushing	xuvetyn	spotify:track:5maUr5RWB1k0CCx8NwlXIc
Mother of Pearl	Lovesliescrushing	xuvetyn	spotify:track:1WKHvdl1NrAv5ECv7nYfTT
All Around You	The Brian Jonestown Massacre	Tepid Peppermint Wonderland - A Retrospective	spotify:track:5unhlswDo9Rx6bxYzv7rEL
Who?	The Brian Jonestown Massacre	Tepid Peppermint Wonderland - A Retrospective	spotify:track:25TBCjoA6c0VdQhUIgj2Ia
When Jokers Attack	The Brian Jonestown Massacre	Tepid Peppermint Wonderland - A Retrospective	spotify:track:13xqV08UUlPPdo3g8VCojL
Servo	The Brian Jonestown Massacre	Tepid Peppermint Wonderland - A Retrospective	spotify:track:5K813OaJulEiQU1pWkehA9
Open Heart Surgery	The Brian Jonestown Massacre	Tepid Peppermint Wonderland - A Retrospective	spotify:track:38iHaYs3H8zwGIAJjTEIeK
If Love Is The Drug	The Brian Jonestown Massacre	Tepid Peppermint Wonderland - A Retrospective	spotify:track:50GGQMN9e17XGSs9pmOfV2
It Girl	The Brian Jonestown Massacre	Tepid Peppermint Wonderland - A Retrospective	spotify:track:20t5cDLXYYh0T6blCAXJVB
Sailor	The Brian Jonestown Massacre	Tepid Peppermint Wonderland - A Retrospective	spotify:track:285HPrQ4qCXiNBeM89Crmg
Straight Up And Down	The Brian Jonestown Massacre	Tepid Peppermint Wonderland - A Retrospective	spotify:track:1j5sl5JYVR0uTrKgnThaxi
Anenome	The Brian Jonestown Massacre	Tepid Peppermint Wonderland - A Retrospective	spotify:track:3fQm5lL6UCCbWaWfffLIsv
Wisdom	The Brian Jonestown Massacre	Tepid Peppermint Wonderland - A Retrospective	spotify:track:2pM5jmsEuzsPKEVuYZYRha
Just For Today	The Brian Jonestown Massacre	Tepid Peppermint Wonderland - A Retrospective	spotify:track:58yBF2V1nBThIFY4Wd0ZOy
Stars	The Brian Jonestown Massacre	Tepid Peppermint Wonderland - A Retrospective	spotify:track:7u4JcNHVsWMzTspJ0ed29O
Vacuum Boots	The Brian Jonestown Massacre	Tepid Peppermint Wonderland - A Retrospective	spotify:track:6Jsp7adLOVat1hfkosrfG4
Prozac vs. Heroin	The Brian Jonestown Massacre	Tepid Peppermint Wonderland - A Retrospective	spotify:track:69QfAO58IDg0cBCSsXTB02
She's Gone	The Brian Jonestown Massacre	Tepid Peppermint Wonderland - A Retrospective	spotify:track:42fKwSMMAhZDTdcqkNy6kR
Oh Lord	The Brian Jonestown Massacre	Tepid Peppermint Wonderland - A Retrospective	spotify:track:5oqm3FUdA9JPMp56ll0V91
Nailing Honey To The Bee	The Brian Jonestown Massacre	Tepid Peppermint Wonderland - A Retrospective	spotify:track:1d6jEJAociXRKIHHTvM375
That Girl Suicide	The Brian Jonestown Massacre	Tepid Peppermint Wonderland - A Retrospective	spotify:track:5WJ9WoU4GC1ck4HrDbsuKX
Nevertheless	The Brian Jonestown Massacre	Tepid Peppermint Wonderland - A Retrospective	spotify:track:0JWpDK6Rh67k2HNIC8InjV
Evergreen	The Brian Jonestown Massacre	Tepid Peppermint Wonderland - A Retrospective	spotify:track:5G2PIlvyCVlpP9mmOTUz0K
Starcleaner	The Brian Jonestown Massacre	Tepid Peppermint Wonderland - A Retrospective	spotify:track:4MTkDYcQtbG9O3eeHNJo6K
Let Me Stand Next To Your Flower	The Brian Jonestown Massacre	Tepid Peppermint Wonderland - A Retrospective	spotify:track:2bfRa7fo3CLOxZNQJ9nPW2
Hide And Seek - Live	The Brian Jonestown Massacre	Tepid Peppermint Wonderland - A Retrospective	spotify:track:7BwnHbnfnQVghTThneG9Rg
In My Life	The Brian Jonestown Massacre	Tepid Peppermint Wonderland - A Retrospective	spotify:track:0mcO8C5ixswUReaDqEiXqz
Mary Please	The Brian Jonestown Massacre	Tepid Peppermint Wonderland - A Retrospective	spotify:track:3a2faQCzYI5dfT3i3dBBsp
Talk - Action = Shit	The Brian Jonestown Massacre	Tepid Peppermint Wonderland - A Retrospective	spotify:track:4Lhi1FYxz7lnorivZwYHBL
This Is Why You Love Me	The Brian Jonestown Massacre	Tepid Peppermint Wonderland - A Retrospective	spotify:track:60gcKN2ZwYKXC6EiU6KFTr
Swallowtail - Live	The Brian Jonestown Massacre	Tepid Peppermint Wonderland - A Retrospective	spotify:track:7EihgDpXXMy9iRdTCHf4AT
Feel So Good	The Brian Jonestown Massacre	Tepid Peppermint Wonderland - A Retrospective	spotify:track:6G5pdFHVz2IZ4OXZbq1Yzb
Fucker	The Brian Jonestown Massacre	Tepid Peppermint Wonderland - A Retrospective	spotify:track:3ZV5k41myh0SJwblXFwgbR
#1 Hit Jam	The Brian Jonestown Massacre	Tepid Peppermint Wonderland - A Retrospective	spotify:track:5xtmxUMqYHOpEb9gYjaf3i
Ballad Of Jim Jones	The Brian Jonestown Massacre	Tepid Peppermint Wonderland - A Retrospective	spotify:track:1PkWMQdt1m9DX89fAEnCZp
Free And Easy Take 2	The Brian Jonestown Massacre	Tepid Peppermint Wonderland - A Retrospective	spotify:track:5iFbemzErWJE3M8iueaBbS
Stolen	The Brian Jonestown Massacre	Tepid Peppermint Wonderland - A Retrospective	spotify:track:540ANamzDqSpmfJIHxFXDc
Mansion In The Sky	The Brian Jonestown Massacre	Tepid Peppermint Wonderland - A Retrospective	spotify:track:5MXpYVze9772Y4sdamcQ40
Sue	The Brian Jonestown Massacre	Tepid Peppermint Wonderland - A Retrospective	spotify:track:7aA3bFvQVxQVkZmEVxIPiz
Time Is Honey (So Cut The Shit) - Bonus Track	The Brian Jonestown Massacre	Tepid Peppermint Wonderland - A Retrospective	spotify:track:5OqqkaWedIzbNWGNhVqPXs
Teleflows vs. Amplification - Bonus Track	The Brian Jonestown Massacre	Tepid Peppermint Wonderland - A Retrospective	spotify:track:0zDO5v3T8FaVOQ2ytHP0hC
God Is My Girlfriend - Bonus Track	The Brian Jonestown Massacre	Tepid Peppermint Wonderland - A Retrospective	spotify:track:7qoaTXbKhJkE5hVZMiu97j
Evergreen	The Brian Jonestown Massacre	Methodrone	spotify:track:4lfvvWKfZrC0VZcxOCp521
Wisdom	The Brian Jonestown Massacre	Methodrone	spotify:track:2OK8gN4OGfHg4K0fwTyq7A
Crushed	The Brian Jonestown Massacre	Methodrone	spotify:track:2jGTON8NGfyJMPwUFL9UzG
That Girl Suicide	The Brian Jonestown Massacre	Methodrone	spotify:track:6bccV5PtAwtFzR8J7qlw1j
Wasted	The Brian Jonestown Massacre	Methodrone	spotify:track:7jYwJsJCQR19VkPlfoXhrh
Everyone Says	The Brian Jonestown Massacre	Methodrone	spotify:track:3W5YR5kRY2ZZOXhsKg5dOV
Short Wave	The Brian Jonestown Massacre	Methodrone	spotify:track:0mdg8vckcxd6zNDrasHRtK
She Made Me	The Brian Jonestown Massacre	Methodrone	spotify:track:1n2LBrEbAJNN5RzKsfkjNI
Hyperventilation	The Brian Jonestown Massacre	Methodrone	spotify:track:3kzEz69aSfbjeig6M73rGh
Records	The Brian Jonestown Massacre	Methodrone	spotify:track:53XQYQYwRhisa6UxLzjaFB
I Love You	The Brian Jonestown Massacre	Methodrone	spotify:track:5NYFMADkbAUUiOj1Unqrwo
End Of The Day	The Brian Jonestown Massacre	Methodrone	spotify:track:0IUkQymxMZ8wp9bgXbkypQ
Outback	The Brian Jonestown Massacre	Methodrone	spotify:track:3zwTdLZmzyugotDAfPk3Mp
She's Gone	The Brian Jonestown Massacre	Methodrone	spotify:track:2Rr8BO9G5SEJSWGPVNQnR7
In India You - Bonus Track	The Brian Jonestown Massacre	Methodrone	spotify:track:4O4SskTG5irmNF3ztmT5UV
Unlisted	The Brian Jonestown Massacre	Methodrone	spotify:track:4WJbVbsqEmYBhqq5jBIpHA

shazamed
Under the Big Black Sun	X	Under The Big Black Sun	spotify:track:2KcFsP8sv82pLY740WSUkg
The Well and the Lighthouse	Arcade Fire	Neon Bible	spotify:track:048buHnzMSZmqbyzr4ZpaL
Turn Me On	Kevin Lyttle	Turn Me On (Online Music)	spotify:track:0RmXtDH1cBMGImRrmn5xL6
Buses Splash With Rain	Frankie Cosmos	Zentropy	spotify:track:0vEKnUAsPfA8ykKa7zvgiD
Someday, Someway - Remastered	Marshall Crenshaw	Marshall Crenshaw (Deluxe)	spotify:track:01wZPk1D0Ar9AnUtAY01yl
Pick It Up	KRS-One	Maximum Strength 2008	spotify:track:0OMtq0O4enxcray0zB7cyY
Overexposure	Sick Of Sarah	2205	spotify:track:4am2Op9j0txtiOiSP9W47J
A Second Home	Repeater	Iron Flowers	spotify:track:17axFEWgszHGQGSERwU2lz
Milwaukee	The Both	The Both	spotify:track:2VL6PCrcWgJfqxruAWCXnY
I Won't Let You Down	OK Go	Hungry Ghosts	spotify:track:2xHlwGuBr9RXu8nlawDUka
Run	The Maine	Forever Halloween (Deluxe Version)	spotify:track:2TQ9zZwI2wRwWfIgwSCnp5
The Difference	The Wallflowers	Bringing Down The Horse	spotify:track:68fU62xt4ppqqihSBQO43H
Waterloo	ABBA	Waterloo	spotify:track:0RzhMHIsFMbOGh0oWDvNNK
Unlikely Hero	The Hoosiers	The Illusion Of Safety	spotify:track:3xScECldVmMzdpnclehrQU
I'm Gonna Make It Better	She & Him	Volume Two	spotify:track:4iUUV6QdrfVbFbKGeS1X9Z
Kangaroo Court	Capital Cities	In A Tidal Wave Of Mystery (Deluxe Edition)	spotify:track:1leXuBiWQMgbvOIIedqbLB
50 Ways to Say Goodbye	Train	California 37	spotify:track:2NniAhAtkRACaMeYt48xlD
The Competition	Kimya Dawson	Remember That I Love You	spotify:track:6ya5wi2GGW0sjVdrf3D873
In The Mouth A Desert	Pavement	Slanted & Enchanted	spotify:track:4sxIeAOLwvwp1Twg6OLPkD
Only In Dreams	Weezer	Weezer	spotify:track:3DkHNCA4QRBQgTzF2T18hm
Black Cat	Broadcast	Tender Buttons	spotify:track:2u24s40bXEMu896fEs1L9L
Stomp!	The Brothers Johnson	Light Up The Night	spotify:track:6VZdUa8JjaGF2LGsiRG9lC
Too Shy	Kajagoogoo	White Feathers	spotify:track:6WEBIVqiEsevfgJefTyuQQ
Too Shy - Extended Version	Kajagoogoo	The Very Best Of Kajagoogoo	spotify:track:3ePc9YMjz2xPMpHosrG9t5
Didn't Fix Me	Dawes	Good Luck With Whatever	spotify:track:4pqcb6b9PoBnK3HSt4tIeo
Hate in Me	Moss Icon	Complete Discography	spotify:track:2LeLrbxNEIV3Qj7igrRdqt
One Last Wish	One Last Wish	1986	spotify:track:6keT25WOyIMSyqlQPCCyHw
reindeer games	Oso Oso	the yunahon mixtape	spotify:track:5sqQpQ3WUEGYimbHvAi2o2
Rose of Sharon	Title Fight	Hyperview	spotify:track:2kSffFiuuEcczXi6VMzrNQ
Casual Discussion in a Dome Between Two Temples	Algernon Cadwallader	Some Kind of Cadwallader	spotify:track:2wAVaUtp3bSg94qB8GeW7N
Hey Kids	Molina, Late Verlane	Hey Kids	spotify:track:5poS8LyxohSACjuIZ61EyS
As I Lay Me Down	Sophie B. Hawkins	Whaler	spotify:track:6S8ZXzeXsfCj8qi9179McI

RnB
All For You	Janet Jackson	All For You	spotify:track:5X8kkUaUlAyAUr9TYqDFTH
No Scrubs	TLC	Fanmail	spotify:track:1KGi9sZVMeszgZOWivFpxs
Together Again	Janet Jackson	The Velvet Rope	spotify:track:1GrikfH0jDejDvrxo84n4P
Miss Independent	Ne-Yo	Year Of The Gentleman (Bonus Track Edition)	spotify:track:34ceTg8ChN5HjrqiIYCn9Q
U Remind Me	Usher	8701	spotify:track:2QsZVnbWVSjKMXK6K3uRBL
Ride Wit Me	Nelly, City Spud	Country Grammar	spotify:track:3Gf5nttwcX9aaSQXRWidEZ
Family Affair	Mary J. Blige	No More Drama	spotify:track:3aw9iWUQ3VrPQltgwvN9Xu
D.'s Car Jam / Anxious Mo-Fo	Minutemen	Double Nickels on the Dime	spotify:track:7uZoHcTmsCn73ed2NedThJ
Theatre Is the Life of You	Minutemen	Double Nickels on the Dime	spotify:track:7l5kOMmACRRDCz2fmGTCtV
Viet Nam	Minutemen	Double Nickels on the Dime	spotify:track:21vp1orbqySVyww9ngW44w
Cohesion	Minutemen	Double Nickels on the Dime	spotify:track:51NHmSOPGDM5zGVooMEDRm
It's Expected I'm Gone	Minutemen	Double Nickels on the Dime	spotify:track:3bbVPVAL3ulmu3kNGJ9EDF
#1 Hit Song	Minutemen	Double Nickels on the Dime	spotify:track:60nriFcKARUpnYksJkDqJR
Two Beads at the End	Minutemen	Double Nickels on the Dime	spotify:track:51MMeFinCcfpGEn8fUga0M
Do You Want New Wave or Do You Want the Truth	Minutemen	Double Nickels on the Dime	spotify:track:5anmC2NmiEOlfp5ahKxKia
Don't Look Now	Minutemen	Double Nickels on the Dime	spotify:track:2xUVQylqgrbkwUnRQyutKG
Shit from an Old Notebook	Minutemen	Double Nickels on the Dime	spotify:track:2z2qTST29C0jxdCGjlqVNE
Nature Without Man	Minutemen	Double Nickels on the Dime	spotify:track:6nT02nLUsL3Xc1LRPzlHsQ
One Reporters Opinion	Minutemen	Double Nickels on the Dime	spotify:track:60UJ75pY9YaL7qpT2KKT3h
Political Song for Michael Jackson to Sing	Minutemen	Double Nickels on the Dime	spotify:track:2hPOhalhnij5ei9Y3VBgBQ
Maybe Partying Will Help	Minutemen	Double Nickels on the Dime	spotify:track:3aXYVBh5xgdHwRbkVrYf5T
Toadies	Minutemen	Double Nickels on the Dime	spotify:track:3rlBU6SOIIDpK9UIItQvWA
Retreat	Minutemen	Double Nickels on the Dime	spotify:track:3W73708ULWFAdR5mtUaJYT
The Big Foist	Minutemen	Double Nickels on the Dime	spotify:track:1lLn8bE7aM5TSjYI1mQheE
God Bows to Math	Minutemen	Double Nickels on the Dime	spotify:track:5LkBMcncPetiP8za7XdAGy
Corona	Minutemen	Double Nickels on the Dime	spotify:track:2LUVo82IKIpCuBNSaqF0G8
The Glory of Man	Minutemen	Double Nickels on the Dime	spotify:track:7fwuT8n8FPJGseqr38zJtE
Take 5, D.	Minutemen	Double Nickels on the Dime	spotify:track:2yDjtl4TU5z77W2MfL3ejK
My Heart and the Real World	Minutemen	Double Nickels on the Dime	spotify:track:0A2C5eJzfGGnDtwRqby1LD
History Lesson Part 2	Minutemen	Double Nickels on the Dime	spotify:track:45fq6kIQtooot7WVRsXAum
You Need the Glory	Minutemen	Double Nickels on the Dime	spotify:track:2D3KQnbneZ1WI02xDal8iN
The Roar of the Masses Could Be Farts	Minutemen	Double Nickels on the Dime	spotify:track:74PzFTj0YKQhtESkU5VrfF
West Germany	Minutemen	Double Nickels on the Dime	spotify:track:3R6jsQgcGKwYHTYHtoTmU8
The Politics of Time	Minutemen	Double Nickels on the Dime	spotify:track:4X2cqABozX3BgzS7G4TmUN
Themselves	Minutemen	Double Nickels on the Dime	spotify:track:0jwiakOoVQkolSUVTnehVs
Please Don't Be Gentle with Me	Minutemen	Double Nickels on the Dime	spotify:track:3aAW52pqLhpZwZQqZocRFU
Nothing Indeed	Minutemen	Double Nickels on the Dime	spotify:track:5y41sQIB4ukaYycIvNO0Pp
No Exchange	Minutemen	Double Nickels on the Dime	spotify:track:4V83QW8mavnEKyjAhcVp20
There Ain't Shit on T.V. Tonight	Minutemen	Double Nickels on the Dime	spotify:track:64H5mnCQXLDzxTlzuisN73
This Ain't No Picnic	Minutemen	Double Nickels on the Dime	spotify:track:3Yu5i8Jwq2anl6mMcKTRge
Spillage	Minutemen	Double Nickels on the Dime	spotify:track:0aocsnZlGirqzJSbisPa15
Untitled Song for Latin America	Minutemen	Double Nickels on the Dime	spotify:track:624TuCJS0AmQEpaDUNkAnm
Jesus and Tequila	Minutemen	Double Nickels on the Dime	spotify:track:1zWKWdQLKZhAON3ZjxlOnf
June 16th	Minutemen	Double Nickels on the Dime	spotify:track:3sglxsW7n68vK0G8140SA1
Storm in My House	Minutemen	Double Nickels on the Dime	spotify:track:5nGWMBcoKyI31X1bAkEwXJ
Martin's Story	Minutemen	Double Nickels on the Dime	spotify:track:2SvYlUac45Z5gFRdJSjMNz
Dr. Wu	Minutemen	Double Nickels on the Dime	spotify:track:4GqCCrm096KlucWDhXiGYN
The World According to Nouns	Minutemen	Double Nickels on the Dime	spotify:track:07GDrCg4yZe0hmksXD3nRh
Love Dance	Minutemen	Double Nickels on the Dime	spotify:track:3FEgOe4ms9sIpxmCSqeF9d
Three Car Jam	Minutemen	Double Nickels on the Dime	spotify:track:1PfIUKoQPM0aHlqSpyR8j3

missing-post-punk
My Tulpa - Remastered 2007	Magazine	Real Life	spotify:track:5gUKP7y8zFxzId27tifnFb
Shot By Both Sides - Remastered	Magazine	Real Life	spotify:track:3aInErz06eEAbRHMnsORR2
Recoil - Remastered 2007	Magazine	Real Life	spotify:track:4a0k2rK9sWBCSv191Jeblx
Burst - Remastered 2007	Magazine	Real Life	spotify:track:0A39JjUf9DmIBTNWgSekxC
Motorcade - Remastered 2007	Magazine	Real Life	spotify:track:2YrCjoA82emnc5hSc4pnL0
The Great Beautician In The Sky - Remastered 2007	Magazine	Real Life	spotify:track:6geYAL5LpKVrmC79qQem8Z
The Light Pours Out Of Me - Remastered 2007	Magazine	Real Life	spotify:track:5fvhUWDLEpICmUCbZYda9N
Parade - Remastered 2007	Magazine	Real Life	spotify:track:2A1kSQXHK2NAETd9JNmq2I
Shot By Both Sides - Original Single Version 2007 - Remaster	Magazine	Real Life	spotify:track:663GG77Wq2Z6TJW0YgqZAt
My Mind Ain't So Open - 2007 Digital Remaster	Magazine	Real Life	spotify:track:2uaosMjVUY0VwM4PVSJGHG
Touch And Go - 2007 Digital Remaster	Magazine	Real Life	spotify:track:2pDvxZPDYVYSDZnKg9eFjA
Goldfinger - 2007 Digital Remaster	Magazine	Real Life	spotify:track:35ozKgaUiZ5ASJZSiIAun6
Sleep	This Heat	Deceit	spotify:track:1IRpZyRNROsmCLbrctnOLs
Paper Hats	This Heat	Deceit	spotify:track:0XqKAig27dZT9AXcup5Zj0
Triumph	This Heat	Deceit	spotify:track:2naFAH2QM31ZJ91D6LIaZN
S.P.Q.R.	This Heat	Deceit	spotify:track:4k7ITzJoWwUSxfSxLMlDFn
Cenotaph	This Heat	Deceit	spotify:track:6TQDlYYRwcS1jbPoQiB8KM
Shrinkwrap	This Heat	Deceit	spotify:track:46o2neDiOIDB00DFiL1z5M
Radio Prague	This Heat	Deceit	spotify:track:2vOZWlrStedfZnCivfaCth
Makeshift Swahili	This Heat	Deceit	spotify:track:4YwRzZUh3S6fdWJEUf79aJ
Independence	This Heat	Deceit	spotify:track:6TV0wxNXCV6UY3p2YG3JyJ
A New Kind of Water	This Heat	Deceit	spotify:track:49fHwhtjn4kCT9SX69JkXV
Hi Baku Shyo (Suffer Bomb Disease)	This Heat	Deceit	spotify:track:1G9Y79melbAz5xOchYLPO0
I Should Have Known Better - 2006 Remastered Version	Wire	154	spotify:track:4NRXsioOK5eh7JN4Um6duP
Two People In a Room - 2006 Remastered Version	Wire	154	spotify:track:5zE3Ktx9kQVNBjQ0CLB9Qd
The 15th - 2006 Remastered Version	Wire	154	spotify:track:6uzfO4Nl3imrQEEbUN8kBY
The Other Window - 2006 Remastered Version	Wire	154	spotify:track:6Z9Pgk2PkLGTlG8gt1S8ME
Single K.O. - 2006 Remastered Version	Wire	154	spotify:track:1F8Otnp7TEIE81K7QvxbU9
A Touching Display - 2006 Remastered Version	Wire	154	spotify:track:69ToRBlsvl4tMXkOVcr4qi
On Returning - 2006 Remastered Version	Wire	154	spotify:track:4JILOKNjlAzjCFlJlR6ouI
A Mutual Friend - 2006 Remastered Version	Wire	154	spotify:track:1Dv2sbWOUCjs6K5V5tq5jz
Blessed State - 2006 Remastered Version	Wire	154	spotify:track:57ETZaC18AsdVfFCGEvFVN
Once Is Enough - 2006 Remastered Version	Wire	154	spotify:track:1vbkJXMFYyth57W07XmMmI
Map Ref 41 Degrees N 93 Degrees W - 2006 Remastered Version	Wire	154	spotify:track:6q6ONvx8Dc3qC7YjfMLF0o
Indirect Enquiries - 2006 Remastered Version	Wire	154	spotify:track:26vobj2PFZBvtqoPfbQIB7
40 Versions - 2006 Remastered Version	Wire	154	spotify:track:2XpWo1xqtW8ttBYgZ9dwDQ
Practice Makes Perfect - 2006 Remastered Version	Wire	Chairs Missing	spotify:track:2vYcX70M5Vx8YMohXFwshw
French Film Blurred - 2006 Remastered Version	Wire	Chairs Missing	spotify:track:6mYjDAyZeCUeOCU1rWJHWx
Another the Letter - 2006 Remastered Version	Wire	Chairs Missing	spotify:track:0xr5ZFyC1SssS1dBHfrP5i
Men 2nd - 2006 Remastered Version	Wire	Chairs Missing	spotify:track:1ptKPZyoKjI7PAJqAC9dVS
Marooned - 2006 Remastered Version	Wire	Chairs Missing	spotify:track:2wqyUVbcUr5WZSXRSqbzIt
Sand in My Joints - 2006 Remastered Version	Wire	Chairs Missing	spotify:track:44e4nrz3QBTLrM7PNfJOD1
Being Sucked in Again - 2006 Remastered Version	Wire	Chairs Missing	spotify:track:5uvsptNfNKPLR2rRZP53nv
Heartbeat - 2006 Remastered Version	Wire	Chairs Missing	spotify:track:2I4rmCub7BpmTay7eioktb
Mercy - 2006 Remastered Version	Wire	Chairs Missing	spotify:track:4jyZHdfC75dIxqJgovAYKv
Outdoor Miner - 2006 Remastered Version	Wire	Chairs Missing	spotify:track:4Lk86divN6elNG9ShrqSuZ
I Am the Fly - 2006 Remastered Version	Wire	Chairs Missing	spotify:track:7FMCSGCHA6hvU3A4NCxEqE
I Feel Mysterious Today - 2006 Remastered Version	Wire	Chairs Missing	spotify:track:78GsxqFGCjl6WWZyeP4Ha0
From The Nursery - 2006 Remastered Version	Wire	Chairs Missing	spotify:track:6wZheTBkUV7wfkH3aFwRlu
Used To - 2006 Remastered Version	Wire	Chairs Missing	spotify:track:6d6rnXGS8vBCJe8P7ctagN
Too Late - 2006 Remastered Version	Wire	Chairs Missing	spotify:track:2eZ8lBCC0oPjNLIE2NxiJA
Reuters - 2006 Remastered Version	Wire	Pink Flag	spotify:track:0T3uPDgL6iErias0LLfJIE
Field Day for the Sundays - 2006 Remastered Version	Wire	Pink Flag	spotify:track:1MQQfz3N6AysgAvbHDHhCa
Three Girl Rhumba - 2006 Remastered Version	Wire	Pink Flag	spotify:track:0bN5W8EhIJhh6zvgeNG57J
Ex Lion Tamer - 2006 Remastered Version	Wire	Pink Flag	spotify:track:5bb71zUIXMD6fsnHBLaoQ6
Lowdown - 2006 Remastered Version	Wire	Pink Flag	spotify:track:2fb7dWrEsTKuPWohoaQHa5
Start to Move - 2006 Remastered Version	Wire	Pink Flag	spotify:track:6ZzgkNscFRe9PiryaeUVwo
Brazil - 2006 Remastered Version	Wire	Pink Flag	spotify:track:5qdsapFwiOWNGh5pFF6ieB
It's So Obvious - 2006 Remastered Version	Wire	Pink Flag	spotify:track:4ospwieFO34SwD90nXqR6r
Surgeon's Girl - 2006 Remastered Version	Wire	Pink Flag	spotify:track:5Afr2zFhd1HPMtAHwdakUx
Pink Flag - 2006 Remastered Version	Wire	Pink Flag	spotify:track:6VvpBt95FoPF01YBqv0vV1
The Commercial - 2006 Remastered Version	Wire	Pink Flag	spotify:track:0mi8mZwiirZfF87H99gXel
Straight Line - 2006 Remastered Version	Wire	Pink Flag	spotify:track:6X7CDzfm1Nq7qZwmRaSUWS
106 Beats That - 2006 Remastered Version	Wire	Pink Flag	spotify:track:6tPUscoU7EpieQLHBBWd0q
Mr Suit - 2006 Remastered Version	Wire	Pink Flag	spotify:track:0Irgm60IPuidNzELI4fMho
Strange - 2006 Remastered Version	Wire	Pink Flag	spotify:track:0GWyL6sgPd7g6yppYNMLaG
Fragile - 2006 Remastered Version	Wire	Pink Flag	spotify:track:55tzW3Ar6PPmh1rNYBqE3l
Mannequin - 2006 Remastered Version	Wire	Pink Flag	spotify:track:5LEwYNnwG1RSVseSmMZQpo
Different to Me - 2006 Remastered Version	Wire	Pink Flag	spotify:track:5OEtdILhohC7GCVio8Uboq
Champs - 2006 Remastered Version	Wire	Pink Flag	spotify:track:6Slsb9yR7U2gvgw4GEGkbV
Feeling Called Love - 2006 Remastered Version	Wire	Pink Flag	spotify:track:3dCgliUWlFmR5pAoBilndg
1 2 X U - 2006 Remastered Version	Wire	Pink Flag	spotify:track:2X7Yq4DYQmEx1bZ1bYjlYx
See No Evil	Television	Marquee Moon	spotify:track:2OaXmeYBJ0hcTmS3kxjJOx
Venus	Television	Marquee Moon	spotify:track:3x0iCzjgf0v9lnwvAhU9P2
Friction	Television	Marquee Moon	spotify:track:7wfvl1kiZJNvhx6HNTyefX
Marquee Moon	Television	Marquee Moon	spotify:track:7Me0vOSlJfaPY7Pc4GeItd
Elevation	Television	Marquee Moon	spotify:track:1pimWzwUERYZbAFr5tL0Xl
Guiding Light	Television	Marquee Moon	spotify:track:6ZHa4WN0lqua4sQHRQFpkc
Prove It	Television	Marquee Moon	spotify:track:3aPjLBWsrqTetCn3QcLSuK
Torn Curtain	Television	Marquee Moon	spotify:track:7p0Pk7IJw1c494Qz5lXopE
The Classical	The Fall	Hex Enduction Hour	spotify:track:4NGX5Xbzdhl4UT3HGqE9ww
Jawbone and the Air-Rifle	The Fall	Hex Enduction Hour	spotify:track:4P0txJ1BUEUHusPycTzOYo
Hip Priest	The Fall	Hex Enduction Hour	spotify:track:1vgEZ8unSRfF3N1eThUka2
Fortress/Deer Park	The Fall	Hex Enduction Hour	spotify:track:2PKRL5MEBk4OOSh504UcYu
Mere Pseud Mag. Ed.	The Fall	Hex Enduction Hour	spotify:track:1NOuCq9AEHvaVEduZoNgCC
Winter (Hostel-Maxi)	The Fall	Hex Enduction Hour	spotify:track:5dG1WYNcgWqlLD4NugnYAy
Winter 2	The Fall	Hex Enduction Hour	spotify:track:5lMiP9ox8fXGXbHIVs1Ron
Just Stop S'ways	The Fall	Hex Enduction Hour	spotify:track:08YLTxGhYhN40U9PyhvtUW
Who Makes the Nazis?	The Fall	Hex Enduction Hour	spotify:track:7rvuBnKaL0w6TUgi0MT92j
Iceland	The Fall	Hex Enduction Hour	spotify:track:33yQNBQQMLSTjBUfT5W6kf
And This Day	The Fall	Hex Enduction Hour	spotify:track:2ssz0ujcJlKkNWTNcA6D6R
Just Like Honey	The Jesus and Mary Chain	Psychocandy	spotify:track:4E6YM4V7Kz6zpbiNsliwEl
The Living End	The Jesus and Mary Chain	Psychocandy	spotify:track:3xg4YGdLrf7lfZv0GBKbHf
Taste the Floor	The Jesus and Mary Chain	Psychocandy	spotify:track:7DwSIfvDNZo4RslGgQNzmw
The Hardest Walk	The Jesus and Mary Chain	Psychocandy	spotify:track:70kEZ0IwNmLf0vxQ7EzGCg
Cut Dead	The Jesus and Mary Chain	Psychocandy	spotify:track:71ipVnuH2x4QCIjfvNYQCB
In a Hole	The Jesus and Mary Chain	Psychocandy	spotify:track:30CB7otbptPUIRCB68nW1f
Taste of Cindy	The Jesus and Mary Chain	Psychocandy	spotify:track:2CFbsphaLiAoayu8nMfCwf
Never Understand	The Jesus and Mary Chain	Psychocandy	spotify:track:3tArKAiS8FGNpU9q3H2Iba
Inside Me	The Jesus and Mary Chain	Psychocandy	spotify:track:0G4vmlGLm7Jw1Y5Vu9kN4e
Sowing Seeds	The Jesus and Mary Chain	Psychocandy	spotify:track:3Xq90u65Zjd8U5oZBvhCsx
My Little Underground	The Jesus and Mary Chain	Psychocandy	spotify:track:4wTHhf4uK520pPZymrHa2G
You Trip Me Up	The Jesus and Mary Chain	Psychocandy	spotify:track:2FODdpnPyXL6lieLuH6JKs
Something's Wrong	The Jesus and Mary Chain	Psychocandy	spotify:track:2PYEXCDGOg4xhWnSVdObti
It's So Hard	The Jesus and Mary Chain	Psychocandy	spotify:track:1f5kATU6mFl7xicJ6Pogro
Non-Alignment Pact	Pere Ubu	Elitism for the People 1975-1978 (Sampler)	spotify:track:0WWmHtyxAuxnuACtwAJMxA
Modern Dance	Pere Ubu	Elitism for the People 1975-1978 (Sampler)	spotify:track:2qOfTfVA5m7zEkMZBaSxF9
Street Waves	Pere Ubu	Elitism for the People 1975-1978 (Sampler)	spotify:track:4ML4hPAYWyOfsGdufjBrmL
Navvy	Pere Ubu	Elitism for the People 1975-1978 (Sampler)	spotify:track:3M6xOmPEaw6r9rWMCmN3Se
On the Surface	Pere Ubu	Elitism for the People 1975-1978 (Sampler)	spotify:track:7gp6wfXBvHmxa7peWFYOMd
Dub Housing	Pere Ubu	Elitism for the People 1975-1978 (Sampler)	spotify:track:2pEZAI8fI5Cr9uwxCn0aT1
30 Seconds Over Tokyo	Pere Ubu	Elitism for the People 1975-1978 (Sampler)	spotify:track:5pQEwrQFzGD3rXxZj9GVXH
Heart of Darkness	Pere Ubu	Elitism for the People 1975-1978 (Sampler)	spotify:track:2eJio1YcMR5Jlrt2v8CMNg
Final Solution	Pere Ubu	Elitism for the People 1975-1978 (Sampler)	spotify:track:3Wi1ZEd9SJTN90Fr4NyFhQ
D.'s Car Jam / Anxious Mo-Fo	Minutemen	Double Nickels on the Dime	spotify:track:7uZoHcTmsCn73ed2NedThJ
Theatre Is the Life of You	Minutemen	Double Nickels on the Dime	spotify:track:7l5kOMmACRRDCz2fmGTCtV
Viet Nam	Minutemen	Double Nickels on the Dime	spotify:track:21vp1orbqySVyww9ngW44w
Cohesion	Minutemen	Double Nickels on the Dime	spotify:track:51NHmSOPGDM5zGVooMEDRm
It's Expected I'm Gone	Minutemen	Double Nickels on the Dime	spotify:track:3bbVPVAL3ulmu3kNGJ9EDF
#1 Hit Song	Minutemen	Double Nickels on the Dime	spotify:track:60nriFcKARUpnYksJkDqJR
Two Beads at the End	Minutemen	Double Nickels on the Dime	spotify:track:51MMeFinCcfpGEn8fUga0M
Do You Want New Wave or Do You Want the Truth	Minutemen	Double Nickels on the Dime	spotify:track:5anmC2NmiEOlfp5ahKxKia
Don't Look Now	Minutemen	Double Nickels on the Dime	spotify:track:2xUVQylqgrbkwUnRQyutKG
Shit from an Old Notebook	Minutemen	Double Nickels on the Dime	spotify:track:2z2qTST29C0jxdCGjlqVNE
Nature Without Man	Minutemen	Double Nickels on the Dime	spotify:track:6nT02nLUsL3Xc1LRPzlHsQ
One Reporters Opinion	Minutemen	Double Nickels on the Dime	spotify:track:60UJ75pY9YaL7qpT2KKT3h
Political Song for Michael Jackson to Sing	Minutemen	Double Nickels on the Dime	spotify:track:2hPOhalhnij5ei9Y3VBgBQ
Maybe Partying Will Help	Minutemen	Double Nickels on the Dime	spotify:track:3aXYVBh5xgdHwRbkVrYf5T
Toadies	Minutemen	Double Nickels on the Dime	spotify:track:3rlBU6SOIIDpK9UIItQvWA
Retreat	Minutemen	Double Nickels on the Dime	spotify:track:3W73708ULWFAdR5mtUaJYT
The Big Foist	Minutemen	Double Nickels on the Dime	spotify:track:1lLn8bE7aM5TSjYI1mQheE
God Bows to Math	Minutemen	Double Nickels on the Dime	spotify:track:5LkBMcncPetiP8za7XdAGy
Corona	Minutemen	Double Nickels on the Dime	spotify:track:2LUVo82IKIpCuBNSaqF0G8
The Glory of Man	Minutemen	Double Nickels on the Dime	spotify:track:7fwuT8n8FPJGseqr38zJtE
Take 5, D.	Minutemen	Double Nickels on the Dime	spotify:track:2yDjtl4TU5z77W2MfL3ejK
My Heart and the Real World	Minutemen	Double Nickels on the Dime	spotify:track:0A2C5eJzfGGnDtwRqby1LD
History Lesson Part 2	Minutemen	Double Nickels on the Dime	spotify:track:45fq6kIQtooot7WVRsXAum
You Need the Glory	Minutemen	Double Nickels on the Dime	spotify:track:2D3KQnbneZ1WI02xDal8iN
The Roar of the Masses Could Be Farts	Minutemen	Double Nickels on the Dime	spotify:track:74PzFTj0YKQhtESkU5VrfF
West Germany	Minutemen	Double Nickels on the Dime	spotify:track:3R6jsQgcGKwYHTYHtoTmU8
The Politics of Time	Minutemen	Double Nickels on the Dime	spotify:track:4X2cqABozX3BgzS7G4TmUN
Themselves	Minutemen	Double Nickels on the Dime	spotify:track:0jwiakOoVQkolSUVTnehVs
Please Don't Be Gentle with Me	Minutemen	Double Nickels on the Dime	spotify:track:3aAW52pqLhpZwZQqZocRFU
Nothing Indeed	Minutemen	Double Nickels on the Dime	spotify:track:5y41sQIB4ukaYycIvNO0Pp
No Exchange	Minutemen	Double Nickels on the Dime	spotify:track:4V83QW8mavnEKyjAhcVp20
There Ain't Shit on T.V. Tonight	Minutemen	Double Nickels on the Dime	spotify:track:64H5mnCQXLDzxTlzuisN73
This Ain't No Picnic	Minutemen	Double Nickels on the Dime	spotify:track:3Yu5i8Jwq2anl6mMcKTRge
Spillage	Minutemen	Double Nickels on the Dime	spotify:track:0aocsnZlGirqzJSbisPa15
Untitled Song for Latin America	Minutemen	Double Nickels on the Dime	spotify:track:624TuCJS0AmQEpaDUNkAnm
Jesus and Tequila	Minutemen	Double Nickels on the Dime	spotify:track:1zWKWdQLKZhAON3ZjxlOnf
June 16th	Minutemen	Double Nickels on the Dime	spotify:track:3sglxsW7n68vK0G8140SA1
Storm in My House	Minutemen	Double Nickels on the Dime	spotify:track:5nGWMBcoKyI31X1bAkEwXJ
Martin's Story	Minutemen	Double Nickels on the Dime	spotify:track:2SvYlUac45Z5gFRdJSjMNz
Dr. Wu	Minutemen	Double Nickels on the Dime	spotify:track:4GqCCrm096KlucWDhXiGYN
The World According to Nouns	Minutemen	Double Nickels on the Dime	spotify:track:07GDrCg4yZe0hmksXD3nRh
Love Dance	Minutemen	Double Nickels on the Dime	spotify:track:3FEgOe4ms9sIpxmCSqeF9d
Three Car Jam	Minutemen	Double Nickels on the Dime	spotify:track:1PfIUKoQPM0aHlqSpyR8j3
Secrets	Mission Of Burma	vs.	spotify:track:4m8UrR2zkvJPyosu9X9roE
Train	Mission Of Burma	vs.	spotify:track:0yf39QCshAh2DB9Kyddk9X
Trem Two	Mission Of Burma	vs.	spotify:track:729fuz26uFFzeTGwiqVGbZ
New Nails	Mission Of Burma	vs.	spotify:track:0IUZR4cfxaCOEBaQ6EbBsP
Dead Pool	Mission Of Burma	vs.	spotify:track:1JzIthytldTVgD7gn7iw9E
Learn How	Mission Of Burma	vs.	spotify:track:5Ueyf1MNQW5KYPlA0owQ6B
Mica	Mission Of Burma	vs.	spotify:track:5D1zqA5MWGf2SRQWfyQmip
Weatherbox	Mission Of Burma	vs.	spotify:track:69dSnIVeRuJLiRtCRmqKb8
The Ballad of Johnny Burma	Mission Of Burma	vs.	spotify:track:7kNiQt36vRRAhBo58z46l3
Einstein's Day	Mission Of Burma	vs.	spotify:track:1kZdqeQbfJvh8tR9uSn5vB
Fun World	Mission Of Burma	vs.	spotify:track:635E9wWOTH59RcjdrmgTF7
That's How I Escaped My Certain Fate	Mission Of Burma	vs.	spotify:track:7EoK0FmkAsEdVejoPSOFRk
Laugh the World Away	Mission Of Burma	vs.	spotify:track:3gdSmnLLiS2adcPgY0WMzE
Forget	Mission Of Burma	vs.	spotify:track:5HDFSE6fAgpYxZEYuF8Kg4
Progress	Mission Of Burma	vs.	spotify:track:2xNLDZpPVpkNdaZV52b5I7
OK/No Way	Mission Of Burma	vs.	spotify:track:0i9XHgFV6xCiKIwu8eS9zF
Academy Fight Song	Mission Of Burma	Signals, Calls and Marches	spotify:track:41BkhNoTpxX8CrGzOiRd7W
Max Ernst	Mission Of Burma	Signals, Calls and Marches	spotify:track:5oY6oukmJN59ixn1yv74P8
Devotion	Mission Of Burma	Signals, Calls and Marches	spotify:track:0H24FnpuB0nu0huwThijux
Execution	Mission Of Burma	Signals, Calls and Marches	spotify:track:6SY6nMEP7RK3XodKI8uJW4
That's When I Reach For My Revolver	Mission Of Burma	Signals, Calls and Marches	spotify:track:5QAQxxN163HxD1uU0BrMYM
Outlaw	Mission Of Burma	Signals, Calls and Marches	spotify:track:0exDaWLUyIIAlg0YsBqjms
Fame And Fortune	Mission Of Burma	Signals, Calls and Marches	spotify:track:5wjAzIV2CuH8jYPRldWd17
This Is Not A Photograph	Mission Of Burma	Signals, Calls and Marches	spotify:track:5CBWM229019nLkYYv38zNC
Red	Mission Of Burma	Signals, Calls and Marches	spotify:track:6wqKYMqdK5Z9KaCo77amzV
All World Cowboy Romance	Mission Of Burma	Signals, Calls and Marches	spotify:track:6yGRchcVKTJS41znDVixpm
Navvy	Pere Ubu	Dub Housing	spotify:track:7zarBl5ddnKYlinGMMWuSA
On the Surface	Pere Ubu	Dub Housing	spotify:track:4wyJ4YyUMnLHhgD1Lq7E2M
Dub Housing	Pere Ubu	Dub Housing	spotify:track:6Gi7twZF70Ux8taa9frcZ4
Caligari's Mirror	Pere Ubu	Dub Housing	spotify:track:4i5d7IP8FdVrGxIipwO3gA
Thriller!	Pere Ubu	Dub Housing	spotify:track:4jZu4RWE0cTw33KA9Axw5Q
I, Will Wait	Pere Ubu	Dub Housing	spotify:track:6DPt9gnFTOaORqsbhVgJvG
Drinking Wine Spodyody	Pere Ubu	Dub Housing	spotify:track:1YyKLQi6y09C01ZV9IngAO
(Pa) Ubu Dance Party	Pere Ubu	Dub Housing	spotify:track:4MJC44MTRW3yNWMoVqkNy6
Blow Daddy-O	Pere Ubu	Dub Housing	spotify:track:5eS23HW99C0ZicWvOKLTDr
Codex	Pere Ubu	Dub Housing	spotify:track:0CXFJyWqJypZeXhX8kjpn6
Futures And Pasts	The Fall	Damaged Goods: Post Punk Sounds	spotify:track:0trS9V3wUxYmnH31FkPpRu

covers
Time After Time	Iron & Wine	Time After Time	spotify:track:5kOBEsqVNwi4udPRbagNIV
Friday I'm in Love	Yo La Tengo	Stuff Like That There	spotify:track:6yH4PtEs8t43GkU7DVORaN
Sweet Child O' Mine	Taken By Trees	Sweet Child o’ Mine	spotify:track:16i6f7yJWs1j67fxBjfc7z
1979	Freedom Fry	1979	spotify:track:2KSezpA4CZxv1RkQvA1jXE
Save It For Later - Live	Pete Townshend	Deep End Live!	spotify:track:0im7UU71hGL0xvehl0WEdS
Drain You	Horse Feathers	Drain You b/w Bonnet of Briars	spotify:track:2DpRkK8BYos1hDNuNlpwHu
This Woman's Work	Greg Laswell	Covers	spotify:track:0J9e43QjshiuFc6whszKZS
Tonight, Tonight	Passion Pit	Tonight, Tonight	spotify:track:6F3Zu1SBa0duBomvXmWUCo
Girls Just Want To Have Fun	Greg Laswell	Girls Just Want To Have Fun	spotify:track:3Qy9NQhUhXKQFXWEBjm4UI
Personal Jesus	Johnny Cash	American IV: The Man Comes Around	spotify:track:5dcwiQFqn0mTcWewYIv7MV
Love Will Tear Us Apart	Evelyn Evelyn	Evelyn Evelyn	spotify:track:3Svtnpfh3ytKY12khvv6h1
Pride, In The Name of Love	John Legend	Yes We Can: Voices Of A Grassroots Movement	spotify:track:4AqE8a9kL0VScOm9AW8Lza
Smells Like Teen Spirit - Radio Edit	Patti Smith	Outside Society	spotify:track:58cKWhCT3I4yhxtNpBlMli
Smells Like Teen Spirit - 2015 Remaster	Tori Amos	Little Earthquakes (Deluxe Edition)	spotify:track:1kWqRB6PHLM9QTfaXuHpIV
All Apologies	Sinéad O'Connor	Universal Mother	spotify:track:1SquBBWJ2qIUAt6GiKZpsq
Hey Ya - solo version	Obadiah Parker	The Tip Jar Volume One	spotify:track:6QeLUyIfNHCJhEMSPGwDgi
With Or Without You - BBC Jo Whiley Session / 2004	Keane	Hopes And Fears (Deluxe Edition)	spotify:track:1hKatvvaKADQVmEPIob9e8
Landslide - Remastered	The Smashing Pumpkins	Pisces Iscariot (Deluxe)	spotify:track:6N7JMoaUYgo4pwPgsnSobr
Norwegian Wood	Heather Nova	Lennon Bermuda	spotify:track:2EK3UM0CKpjxMVk6JWRONr
Tainted Love	Hannah Peel	Rebox	spotify:track:0veEsZjFQOLS0H0xXVyrtu
Bizarre Love Triangle - Live from Spotify NYC	Echosmith	Spotify Sessions	spotify:track:5g5M6CQIy5boBdxhKo8bxU
This Must Be the Place (Naive Melody) [by Talking Heads]	Kishi Bashi	7" Singles	spotify:track:0udJrKQOgJz6TwZXuhi7IM
Somewhere Only We know - Live from Spotify, London	Lily Allen	Spotify Sessions	spotify:track:7FnHpKPgVC6GE0RRCJNB2T
Show Me The Meaning Of Being Lonely	Anna Ternheim	For The Young	spotify:track:4AxIU7R7grPIgl8m6xhvke
Losing My Religion - The Voice Performance	Dia Frampton	Losing My Religion (The Voice Performance)	spotify:track:0Q5U5alAt2pjop9331E5cQ
Paranoid Android	Sia	Exit Music: Songs With Radio Heads	spotify:track:2o8QYkTODvc2JhZWatfnRG
Hotline Bling	Kalle Mattson	Hotline Bling	spotify:track:71gWiiWxYqp2p4DYAnNQay
I Touch Myself - Live in NYC	Julia Stone	Spotify Sessions	spotify:track:7aJEEuTo97fpMSiFPsbbSA
There Is a Light That Never Goes Out	Dum Dum Girls	He Gets Me High	spotify:track:2ZQqzNzi8D4Fp99uj5NAGC
Still Haven't Found What I'm Looking For	Juliet Turner	Even Better Than the Real Thing Vol. 3	spotify:track:0pQ97WL2JjfaHFByXSlBkJ
Don't Speak	Sarah Menescal	The Voice of the New Bossa Nova	spotify:track:5BxPC0hfPuUEq2vruFZLFh
Dancing Queen	Erato	Dancing Queen	spotify:track:7EfG2ksEzOhZ8olWDi36rd
Somebody to Love	Branches	Covers	spotify:track:0L9fWUcLnPIf5Z7rljJ8Mm
With or Without You	Cunnie Williams	Star Hotel	spotify:track:1wqYkwM0okOXdfM3JZuAuw
Logical Song	Small Is Beautiful	10 years, 5 songs	spotify:track:6XMYaFARz1buYl9NBX8Wog
Blue Monday	Hannah Peel	Rebox	spotify:track:0UCqoj2SUbOMh5QCNMVECP
Total Eclipse of the Heart	Sleeping At Last	Covers, Vol. 1	spotify:track:1650yatyByhD11nXbD8ktd
Just Like Heaven	The Watson Twins	Fire Songs	spotify:track:6HSwdJ6rsfBkUnz6BEsxLN
Fade Into You	Ben Harper	Sweetheart 2014	spotify:track:0CUoECt9C8MfiQWoEijQpb
Oops!... I Did It Again	Julia Zahra	Julia van der Toorn	spotify:track:1KEUxTw1O2z0QKBBz8w0ZU
Sunday Morning	BØRNS, Petite Meller	Sunday Morning	spotify:track:2zqd6xGuFVYeh16DN2UAek
Never Gonna Give You Up	Hannah Trigwell	Cover Sessions, Vol. 2	spotify:track:4kgRgBDdyIg0J67LvUbvtR
Roxanne	Michael Paynter	Money On Your Tongue	spotify:track:7lJ3lmdRszOoNak01nVpCH
Time After Time - The Voice Performance	Javier Colon	Time After Time (The Voice Performance)	spotify:track:03yihw8LFlfZ3EfaLk1A1A
Can’t Help Falling In Love - Live At Daytrotter	Ingrid Michaelson	Be OK	spotify:track:2nOkNoBuQdo5HH0Ls1zXxS
Kiss Me - AOL Sessions Acoustic Version	Sixpence None The Richer	AOL Sessions	spotify:track:79z7dHVpP3ODaat0CK29db
Roxanne - Single Version	Sofia Essaidi	Mon Cabaret	spotify:track:5iQWwNyzXZrub7mhBuWk6B
Walk of Life	Bhi Bhiman	Walk of Life	spotify:track:7y0Unnw8MJEM3enxpoaxeF
Bizarre Love Triangle - 2014 Remaster	Frente!	Marvin The Album - 21st Anniversary Edition	spotify:track:7sgi66biRYpAXuRZJBDuli
Every Little Thing She Does Is Magic	Flower Power	80's in Jazz: Smooth Jazzy Pop Greats (Love is in the Air, Stayin' Alive, Whose Side Are You On, Thriller e tante altre)	spotify:track:1WDYRWadu4TLIKiLXmokGK
Turn! Turn! Turn!	Dan Zanes, Elizabeth Mitchell	Turn Turn Turn	spotify:track:3eFNRykgZuPJPaqOrNO0kF
God Only Knows	Monalisa Twins	MonaLisa Twins Play Beatles & More	spotify:track:3OFcDTqemf7EosLfMCtAPo
Every Breath You Take	Karen Souza	Karen Souza Essentials	spotify:track:4u2b3QdJ6FkyaaTK0TrRQR
Don't You (Forget About Me)	KT Tunstall	Songs To Save A Life In Aid Of Samaritans	spotify:track:6OX9WPnZq1NmtnzQTbMdmv
Bizarre Love Triangle	BSO	Publicidad	spotify:track:3l4G01QMNTFGxTX69z4pP3
Call Me Maybe	Alex G	Call Me Maybe	spotify:track:2VG1NIvcTmtQi2lhbxj3xq
Fields Of Gold	Eva Cassidy	Songbird	spotify:track:5vtOJrmovXGxGsnAck694H
Losing My Religion - Live From Oosterpoort,Netherlands/2001	Anouk	Update	spotify:track:6L0zkASp1b66hmLiM7hd6J
No Woman, No Cry	Karizma Duo	Acoustic Duo	spotify:track:736ayK6HcHeSymBfvQ4uQR
Lovefool	Kat Edmonson	Take To The Sky	spotify:track:1N7lfz33PThaKXXOrSluxv
Time After Time - 2013 Remaster	Everything But The Girl	Worldwide (Deluxe Edition)	spotify:track:2oegLRxfDf5umztOjf13sU
Losing My Religion	Jacqui Naylor	You Don't Know Jacq	spotify:track:3zV5iYPyZUgcaFCcPem3ZN
Boys Don't Cry	Jamie Lancaster	Joyride	spotify:track:31XtkHoLg505WRaO8Ly8RR
Everybody Wants To Rule The World - From “The Hunger Games: Catching Fire” Soundtrack	Lorde	The Hunger Games: Catching Fire (Original Motion Picture Soundtrack)	spotify:track:6zLq4lYSu2W7LLxJlUWzz8
New Years Day	ASLAN	Even Better Than the Real Thing Vol. 3	spotify:track:6WZlAl8dhuBBoMwHeKtTDm
California Dreamin'	Amason	California Airport Love	spotify:track:41uHv2ZIT0YDUHoyNzvRQ1
Like a Virgin	The Cooltrane Quartet	Cool Jazz Blends	spotify:track:16fmIwizFevhtedsBsHRIe
Electric Feel	Jason Joseph & The Spectacular	Don't Let Go / Electric Feel	spotify:track:4XY2eiZpUto9Ji2NoGuKKe
Clocks	Personal Belongings	Personal Belongings	spotify:track:1s5O2wmmKTDDB2Zwrp0oNH
All My Loving	Rita Lee	Aqui, Ali, Em Qualquer Lugar	spotify:track:5dIZa3pwSn1vDenZpSBEFO
Song 2	Emm Gryner	Girl Versions	spotify:track:1yHlh2oJHgsVr26RYdEi71
Heroes	Janelle Monáe	Heroes (Pepsi Beats Of The Beautiful Game)	spotify:track:63ouCvRO1W9dpCl4D9Iotz
Enjoy The Silence	Carla Bruni	French Touch	spotify:track:4PZa10hp40IiPySg7MGYbl
Solsbury Hill	Kyte	Two Sparks, Two Stars	spotify:track:6bYpL7OVWeBk58CRZMWHmA
I Melt with You	Nouvelle Vague, Silja	Nouvelle vague	spotify:track:65zLNCRs7lDEkah5vuNZDt
Sultans of Swing	Leo Giannetto's Jazz Project	Pop Jazz Performances	spotify:track:6c6XUrwnDF0ltAYZZNX8GY
Rebel Rebel	John Vanderslice	John Vanderslice Plays David Bowie's Diamond Dogs	spotify:track:5EixGHroC6z0JFhjOxSo1I
Light My Fire - Remastered	José Feliciano	Feliciano	spotify:track:1348ERWpfnXaKiMQSMjBu1
Please, Please, Please, Let Me Get What I Want	She & Him	(500) Days of Summer (Music from the Motion Picture)	spotify:track:3XcYPyuk0BwiB4w6tgKpOC
Viva La Vida - Acoustic Version	Sofia Karlberg	Viva La Vida (Acoustic Version)	spotify:track:1JlS2AdTKUewprEVwfHWk3
Strawberry Fields Forever	Karen Souza, Los Panchos	Karen Souza Essentials	spotify:track:5rnE9eTK56v1cUub8BAKeL
Lithium	Bruce Lash	Prozak for Lovers II	spotify:track:63AqIb6Z0o9QlZzmOeZWAL
Yesterday	Betty Says	Jazz and Essentials	spotify:track:5oi4uUko19UklxsIDFMYh6
Eleanor Rigby	Joan Baez	Joan	spotify:track:11g7tN5EprSCIwASIN6Jxn
Always On My Mind	Ane Brun	Leave Me Breathless	spotify:track:6xgZswMoI5ncV8e5jhiRsC
Maps (Acoustic) [feat. Ali Brustofski]	Corey Gray, Ali Brustofski	Maps (Acoustic) [feat. Ali Brustofski]	spotify:track:4R2oHU0vr7wpDvbIxXzFGN
Running Up That Hill	Placebo	Covers	spotify:track:6RHHbAbyIcPpvS1dP3KUGq
1979	Darlingside	Whippoorwill	spotify:track:2xq0fx3i99PG6VRc4EDc7B
1979	The Contortionist	Our Bones	spotify:track:33dw9ePKar5xFUrTIKUh6G

emo
reindeer games	Oso Oso	the yunahon mixtape	spotify:track:5sqQpQ3WUEGYimbHvAi2o2
Casual Discussion in a Dome Between Two Temples	Algernon Cadwallader	Some Kind of Cadwallader	spotify:track:2wAVaUtp3bSg94qB8GeW7N
Spit Fountain	Algernon Cadwallader	Algernon Cadwallader	spotify:track:7EUYYZnCgqZnGpwPyesEyf
Rose of Sharon	Title Fight	Hyperview	spotify:track:2kSffFiuuEcczXi6VMzrNQ
No More Pain	Embrace	Embrace	spotify:track:6iXwsEpeAWfX9Eno0tU1F8
Hate in Me	Moss Icon	Complete Discography	spotify:track:2LeLrbxNEIV3Qj7igrRdqt
I'm Back Sleeping, Or Fucking, Or Something	Moss Icon	Complete Discography	spotify:track:6FyIEj9WupcNHWEqhL4Ocj
Mirror	Moss Icon	Complete Discography	spotify:track:50bXJsowHhhrwcbNXSNMWg
One Last Wish	One Last Wish	1986	spotify:track:6keT25WOyIMSyqlQPCCyHw
My Better Half	One Last Wish	1986	spotify:track:6T1Sl5yImArteEmRBJyrEZ
Hide	One Last Wish	1986	spotify:track:2OjtVOfsPjruUbIa39XXEI
Deeper Than Inside	Rites of Spring	Rites of Spring	spotify:track:7J9univk0oJ6h8MBcjh9Os
Head in the Ceiling Fan	Title Fight	Floral Green	spotify:track:7BJny7nQN5bY4EeGVU3kj6
Your Pain Is Mine Now	Title Fight	Hyperview	spotify:track:03n2zDv0TXbH2q9XpzYpqY
Give Me Back	Embrace	Embrace	spotify:track:7u4oj9nfqmyXRRN4nW9Fzg
Building	Embrace	Embrace	spotify:track:6fjKGSWHc1vguUx7qTjfKu

Gang Starr
Full Clip	Gang Starr	Full Clip: A Decade Of Gang Starr	spotify:track:30oTS7bm0aH3p7lqjEIu8q
Work	Gang Starr	Moment Of Truth	spotify:track:1EiLrPd8JMTcQUr1aLEUKi
Above The Clouds	Gang Starr, Inspectah Deck	Moment Of Truth	spotify:track:3ZBSXNYdTZVaBUQI3E2rF6
You Know My Steez	Gang Starr	Moment Of Truth	spotify:track:2C3QwVE5adFCVsCqayhPW7

Shoegaze Space Station
Keen On Boys	The Radio Dept.	Marie Antoinette (Original Motion Picture Soundtrack)	spotify:track:0dCfgEyxU3RyOBtAZw3vPm
babysbreath	Lovesliescrushing	bloweyelashwish	spotify:track:48YfnWuAbgGk1ZrBMSmsBy
The Tiger Hunts Alone	Lovesliescrushing	Ghost Colored Halo	spotify:track:4neEmJ8cVzzOeE6WEOFAFR
babysbreath	Lovesliescrushing	bloweyelashwish	spotify:track:7Cwt68khwNZg4yc9enbjsY
dizzy	Lovesliescrushing	bloweyelashwish	spotify:track:7r3ebY2xYnOxiACOIsRZWT
Breeze	Lush	Gala	spotify:track:5nA0q42fuQ0tGIityR77RP
Sweetness and Light	Lush	Gala	spotify:track:1Pr2b8WV0rFkSAjrnzUeDc
Sunbathing	Lush	Gala	spotify:track:0Mx4zIk3PqzD8Fne4KSssM
Thoughtforms	Lush	Gala	spotify:track:6wXVVppPXjHoMn44v7sEVx
Scarlet	Lush	Gala	spotify:track:7LzjjkqO2YdBOSyb9uI3hx

Bachata
Me Voy	Héctor Acosta "El Torito"	Hector Acosta "El Torito" Los Número Uno	spotify:track:2JMXEFjheY0ggD0g05fMk4
Ojalá	Héctor Acosta "El Torito"	Hector Acosta "El Torito" Los Número Uno	spotify:track:2j3gx76jVENfLl7lN2I0L2
Los Infieles	Aventura	K.O.B. Live	spotify:track:0HDHY6RSHHG2ZTE0cMT4GJ
No Moriré	Héctor Acosta "El Torito"	Hector Acosta "El Torito" Los Número Uno	spotify:track:3ujYUfbEOGHGh0SOvg9Tnp
Tu Primera Vez	Héctor Acosta "El Torito"	Hector Acosta "El Torito" Los Número Uno	spotify:track:3TBK9fEW6z3i4FERHX0YX6
Tu Veneno	Héctor Acosta "El Torito"	Hector Acosta "El Torito" Los Número Uno	spotify:track:0XIXk37vbgwaQEp7x4mCuD
Perdóname la Vida	Héctor Acosta "El Torito"	The Ultimate Bachata Collection	spotify:track:7jkIwEJXP3nmTO3fsCJmnS
El Desprecio	Aventura	The Last	spotify:track:4m9QqcnlQtpCvqxCoClkh3
ileso	Romeo Santos, Teodoro Reyes	Utopia	spotify:track:2zHgz7X52WqdckhjMJj6mt
Naciste para Mi	Teodoro Reyes	15 Exitos	spotify:track:1uVq5XUmKBL3asiZtzGyRt
Tu Eres Mi Hembra	Teodoro Reyes	Sentimiento	spotify:track:6VG22s0gnTLHXsE3b0tTcY

New-p
Electric (feat. Khalid)	Alina Baraz, Khalid	The Color Of You	spotify:track:2mj7x99sNUsVHPBRK51zlG
salvia plath	Teen Suicide	dc snuff film / waste yrself	spotify:track:29q4TGnVDnoyIqAoEemQBK
Salvia Plath	Salvia Plath	The Bardo Story	spotify:track:0cWLd9MQJJRw7iKe3yWoR3
Ecstasy	Soviet Soviet	Fate	spotify:track:60sge80Y7m9wgd03OV4xWa

newnew
Lipstick	Ariel Pink	pom pom	spotify:track:2i1nmBnMkDGFTTjeGGIOTm
Put Your Number in My Phone	Ariel Pink	pom pom	spotify:track:0gBrJS89BL4r8rqjDEzbtp
White Freckles	Ariel Pink	pom pom	spotify:track:0PF4cbrLPZsteUM79VGKGE
Hopeless	KT Tunstall	Drastic Fantastic	spotify:track:2dt1W8hzKWyazEDtY1A47W

newgoth

It's new
You Said Something	PJ Harvey	Stories From The City, Stories From The Sea	spotify:track:4m5S4wvLY031rN6beIWoRe
Tipota Den Hathike - Live	Sokratis Malamas	Alexiou - Malamas - Ioannidis (Live)	spotify:track:6uPhL8S83jlPcbUc4ImTIR
O Kosmos Pou Allazei	Alkinoos Ioannidis	Oi Peripeteies Enos Proskyniti	spotify:track:7eq0a7HISgTaLbMLlJU6mA
Tha 'mai Konta Sou (Otan Me Thes)	Alkinoos Ioannidis	Anemodeiktis	spotify:track:4vbgfw5w2BKT0Hlyx9mXsw
Oli I Zoi Mou	Giannis Parios	Alli Mia Fora	spotify:track:2JC9UTAU3yAzlJlEU68QrR
O Kosmos Pou Allazi - Live	Alkinoos Ioannidis	Alexiou - Malamas - Ioannidis (Live)	spotify:track:3zSiwX9OL3U6GSqSEszDwc
Stin Agora Tou Al Chalili	Alkinoos Ioannidis	Stin Agora Tou Kosmou	spotify:track:6h7YlLnjkA2JYaGx6ntn6s
Tsigaro Atelioto - Live	Haris Alexiou, Sokratis Malamas, Alkinoos Ioannidis	Alexiou - Malamas - Ioannidis (Live)	spotify:track:1xFcm3NVkfCakguvdlQUvi
Big Exit	PJ Harvey	Stories From The City, Stories From The Sea	spotify:track:4J4wU1a0MqhrBMBN2RzFUw
Good Fortune	PJ Harvey	Stories From The City, Stories From The Sea	spotify:track:1G1YJPV7THViQfOM9Gug7R
A Place Called Home	PJ Harvey	Stories From The City, Stories From The Sea	spotify:track:4QmBs5a3mFFLaLA1QTEVrN
One Line	PJ Harvey	Stories From The City, Stories From The Sea	spotify:track:4pi4ALVH55uuzWAXb8Tkb2
Beautiful Feeling	PJ Harvey, Thom Yorke	Stories From The City, Stories From The Sea	spotify:track:2pCRZXPcKiB4UZMvqS4ZYw
The Whores Hustle And The Hustlers Whore	PJ Harvey	Stories From The City, Stories From The Sea	spotify:track:27teiR4hpiFzsWnstV4Ad9
This Mess We're In	PJ Harvey, Thom Yorke	Stories From The City, Stories From The Sea	spotify:track:3vNFsxBbA4dPkymPF5Jm1b
You Said Something	PJ Harvey	Stories From The City, Stories From The Sea	spotify:track:4m5S4wvLY031rN6beIWoRe
Kamikaze	PJ Harvey	Stories From The City, Stories From The Sea	spotify:track:5vdavx9R3iZOJwAxnUH7RP
This Is Love	PJ Harvey	Stories From The City, Stories From The Sea	spotify:track:04Glred2wGdSNH11Qh4EDe
Horses In My Dreams	PJ Harvey	Stories From The City, Stories From The Sea	spotify:track:2W8ace2rlaN5NVGywZMtbG
We Float	PJ Harvey	Stories From The City, Stories From The Sea	spotify:track:0FTdrBz10BKS1LI7rXAjFp
Rid Of Me	PJ Harvey	Rid Of Me	spotify:track:3m2Zd230K68bC4Qe961d9p
Missed	PJ Harvey	Rid Of Me	spotify:track:2tVMNPTbICJLm80kJP95aJ
Legs	PJ Harvey	Rid Of Me	spotify:track:2UVPkh6lrARjYDK42jC6kD
Rub 'Til It Bleeds	PJ Harvey	Rid Of Me	spotify:track:2nZdhNwhvoaUIDqPG9rtz1
Hook	PJ Harvey	Rid Of Me	spotify:track:6B7b8ZdZUkPcjdrzVNvmse
Man-Size Sextet	PJ Harvey	Rid Of Me	spotify:track:7basDIxL6qM7v0N8NP1bGo
Highway '61 Revisited	PJ Harvey	Rid Of Me	spotify:track:1weOavX2CfP2pfGNVTVMsT
50ft Queenie	PJ Harvey	Rid Of Me	spotify:track:3fJprjhRxTVtOp18EHdNfu
Yuri-G	PJ Harvey	Rid Of Me	spotify:track:72W93VrqRaDiyn3FushDXO
Man-Size	PJ Harvey	Rid Of Me	spotify:track:3X4qUkEhAvGY3qIlpNh1sl
Dry	PJ Harvey	Rid Of Me	spotify:track:2fhwvSptDeBj8Yw9FufioZ
Me-Jane	PJ Harvey	Rid Of Me	spotify:track:1YAlQXgiLY8tck2VcTjo4G
Snake	PJ Harvey	Rid Of Me	spotify:track:7dETHzGnQLFEtMYCrCgP5N
Ecstasy	PJ Harvey	Rid Of Me	spotify:track:6I5ltr1XlluBzLGEV2W1bY
Modern Girl	Sleater-Kinney	The Woods	spotify:track:4lWi8GnQbYUmX9j0Y1Cx9u
Dig Me Out	Sleater-Kinney	Dig Me Out (Remastered)	spotify:track:1TvXbNhFRbrp1SIenQ2NHM
Can I Go On	Sleater-Kinney	The Center Won't Hold	spotify:track:33kTpZiXOEs9yQrSzn0cV5
One More Hour	Sleater-Kinney	Dig Me Out (Remastered)	spotify:track:3ccsKRKg0NEfiDaeYnIauK
Jumpers	Sleater-Kinney	The Woods	spotify:track:1Ekf4LfkzpVbwoUawE9R3E
Hurry On Home	Sleater-Kinney	The Center Won't Hold	spotify:track:6EUSmVljC3J77F8SHpthqm
A New Wave	Sleater-Kinney	No Cities to Love	spotify:track:2audHw8H7pcDViQBXAufEZ
I Wanna Be Your Joey Ramone	Sleater-Kinney	Call the Doctor (Remastered)	spotify:track:1NVq4MTXJVqJ1Dw7LJ6KD4
The Fox	Sleater-Kinney	The Woods	spotify:track:1bnCl0lurjeZk8wtddHFYI
The Future Is Here	Sleater-Kinney	The Center Won't Hold	spotify:track:5Cj4uKo0JGQsh6o63m55Yx

irp-maybe
Centerfold	Smallpools	THE SCIENCE OF LETTING GO	spotify:track:63pIhvnCu1lUAVWiJMbmah
Digger	Great Grandpa	Four of Arrows	spotify:track:6qEEi8NSpxJfORl3YRxzea
Fade to Black	Born Ruffians	Uncle, Duke & The Chief	spotify:track:0hf379sSD5IZ4BZLvG0aJj

specktor-p
The Call	Regina Spektor	The Call	spotify:track:341863z079BT4EFPiSw9DP
Fidelity	Regina Spektor	Begin to Hope (Special Edition)	spotify:track:6GskIhdM6TN6EkPgeSjVfW
Samson	Regina Spektor	Begin to Hope (Special Edition)	spotify:track:2bbhyUWJ5VjdfI3P4PRLu2
Two Birds	Regina Spektor	Far	spotify:track:2n0U2OG5d6TuW5mKx7YrC0
Modern Girls & Old Fashion Men	The Strokes, Regina Spektor	Modern Girls & Old Fashion Men	spotify:track:4yVixayMpxm2MUGOePA192
Eet	Regina Spektor	Far	spotify:track:0N9WhEz6DiBDvBxa6uJCTY
Us	Regina Spektor	Soviet Kitsch	spotify:track:6zJms3MX11Qu1IKF44LoRW
You've Got Time	Regina Spektor	You've Got Time	spotify:track:1vDMGBzqLJWZC5UzePDURw
On the Radio	Regina Spektor	Begin to Hope (Special Edition)	spotify:track:6uA9lKAYHcBLhxb5KZYygj
Dear Theodosia (feat. Ben Folds)	Regina Spektor, Ben Folds	The Hamilton Mixtape	spotify:track:1fq4k7G5kYqUvKIuEmFAAo
Fidelity	Regina Spektor	Begin to Hope (Special Edition)	spotify:track:6GskIhdM6TN6EkPgeSjVfW
Better	Regina Spektor	Begin to Hope (Special Edition)	spotify:track:7IUBNrgkUH8XzlEWTOb1Qc
Samson	Regina Spektor	Begin to Hope (Special Edition)	spotify:track:2bbhyUWJ5VjdfI3P4PRLu2
On the Radio	Regina Spektor	Begin to Hope (Special Edition)	spotify:track:6uA9lKAYHcBLhxb5KZYygj
Field Below	Regina Spektor	Begin to Hope (Special Edition)	spotify:track:0AeisMW0Zm6skbZOBLwxx8
Hotel Song	Regina Spektor	Begin to Hope (Special Edition)	spotify:track:3hMeLjX7z3VCZVsJYJ9Ar8
Après Moi	Regina Spektor	Begin to Hope (Special Edition)	spotify:track:2MLPOGnN3OtAYpMt7f93SB
20 Years of Snow	Regina Spektor	Begin to Hope (Special Edition)	spotify:track:7i3fQwYoO7v03l36KrE73c
That Time	Regina Spektor	Begin to Hope (Special Edition)	spotify:track:1eFlXudtmDd6faXHT7RdAe
Edit	Regina Spektor	Begin to Hope (Special Edition)	spotify:track:6c3p4BDn61s1FfR6gJLZap
Lady	Regina Spektor	Begin to Hope (Special Edition)	spotify:track:0MhyoQLsRhjEqNBFOHfpuX
Summer in the City	Regina Spektor	Begin to Hope (Special Edition)	spotify:track:6uPRewLICfMkEsU3OMrlcB
Another Town	Regina Spektor	Begin to Hope (Special Edition)	spotify:track:2vS1A9H4KVHH291HqWRPmK
Uh-merica	Regina Spektor	Begin to Hope (Special Edition)	spotify:track:3qaWrudsPNYQvHGVKiL1AX
Baobabs	Regina Spektor	Begin to Hope (Special Edition)	spotify:track:0ZC4AlsqKE5IAQzELJb0oo
Düsseldorf	Regina Spektor	Begin to Hope (Special Edition)	spotify:track:2UcoGmLXUCvD2yLA34S7lL
Music Box	Regina Spektor	Begin to Hope (Special Edition)	spotify:track:3cUGzeL003o8GIiY2xDDIH

Auditnow
Newspaper Spoons	Preoccupations	Viet Cong	spotify:track:4xvEGLCai1xbgUpMlRkxAG
Pointless Experience	Preoccupations	Viet Cong	spotify:track:1Id5XulbhDmhH2vDNTLQiP
March of Progress	Preoccupations	Viet Cong	spotify:track:2L5lWX4pagbHRIMV1YVBy5
Bunker Buster	Preoccupations	Viet Cong	spotify:track:7rqZJ8JM8nlNHb4p8eCSTR
Continental Shelf	Preoccupations	Viet Cong	spotify:track:3d5lGpqxg1cMEYrgTaGxZy
Silhouettes	Preoccupations	Viet Cong	spotify:track:07cUDeewEa1wMfKHUakxtK
Death	Preoccupations	Viet Cong	spotify:track:69izLOjRU2txMIcNghWd0I
The Devil in His Youth	Protomartyr	The Agent Intellect	spotify:track:4gYKox72XEHWLsKHBsPEL5
Cowards Starve	Protomartyr	The Agent Intellect	spotify:track:2GOncz0yupivM8gTNqI0ni
I Forgive You	Protomartyr	The Agent Intellect	spotify:track:4LbYMAWT2ApEARMMjOHxvP
Boyce or Boice	Protomartyr	The Agent Intellect	spotify:track:7HkMMiq88VUWP0Inr5cg8n
Pontiac 87	Protomartyr	The Agent Intellect	spotify:track:2258MfnrxFPlI46lE6f1Iz
Uncle Mother's	Protomartyr	The Agent Intellect	spotify:track:62zxgGLwnoJyZKCmNX2Kjt
Dope Cloud	Protomartyr	The Agent Intellect	spotify:track:7DKStSTQxDrhBmLCOvO6qN
The Hermit	Protomartyr	The Agent Intellect	spotify:track:2wxI72CJ3WQ3SUyNRleXnh
Clandestine Time	Protomartyr	The Agent Intellect	spotify:track:0X7nnlWwGy4Baq7eUpGAoR
Why Does It Shake?	Protomartyr	The Agent Intellect	spotify:track:3Fqgd0BtDJkHrHk4Q2Yq8o
Ellen	Protomartyr	The Agent Intellect	spotify:track:5Zv0ICd6fclpe1rY3K6udM
Feast of Stephen	Protomartyr	The Agent Intellect	spotify:track:03G9uPkT8Xcz6HqrxSPr3n
A Private Understanding	Protomartyr	Relatives In Descent	spotify:track:7BVk87ORFR4imfNwHOFPs2
Here Is The Thing	Protomartyr	Relatives In Descent	spotify:track:18wNLr1R1cD0UD010WEIJp
My Children	Protomartyr	Relatives In Descent	spotify:track:6fd5sPEa5gFBDaQ3mkj7Zd
Caitriona	Protomartyr	Relatives In Descent	spotify:track:3xrQjt12U3dN5YPqqEPHnI
The Chuckler	Protomartyr	Relatives In Descent	spotify:track:0LeG6rLnZikAoLQMhSNSBW
Windsor Hum	Protomartyr	Relatives In Descent	spotify:track:4BrhQxpQz9rkP8E0BDlluP
Don’t Go To Anacita	Protomartyr	Relatives In Descent	spotify:track:5XmmNOaaE9Y6jyMMaxX2TT
Up The Tower	Protomartyr	Relatives In Descent	spotify:track:6PT7rwuJ7VRa40Qad2pw9B
Night-Blooming Cereus	Protomartyr	Relatives In Descent	spotify:track:69fTwCV254As5JMpa8rlSz
Male Plague	Protomartyr	Relatives In Descent	spotify:track:5xsMey4SLi6Ir8DQgBrDYe
Corpses In Regalia	Protomartyr	Relatives In Descent	spotify:track:6vyxUUHQQkguxWp3bH1JZZ
Half Sister	Protomartyr	Relatives In Descent	spotify:track:6zbFlDUqDdLbHikceCg64h

Jaguares
Quisiera Ser Alcohol	Jaguares	El Primer Instinto	spotify:track:69Ndy0qxbyzllGmhiAWdeF
No Dejes Que	Jaguares	El Primer Instinto	spotify:track:3XluhR9U6ToARwWAl9W1QU
Viento	Jaguares	El Primer Instinto	spotify:track:3QgQOG31uWJUDQ6EEXodRc
Te Lo Pido por Favor	Jaguares	El Primer Instinto	spotify:track:6iRkrVOhCjgKFB2cBWnx4M
Perdí Mi Ojo de Venado	Jaguares	El Primer Instinto	spotify:track:4rZUtQtnJ0eDVjMMPo4sdY
Antes de Que Nos Olviden	Jaguares	El Primer Instinto	spotify:track:5cSAiMbw4oQOuZlA5iHFTl
Mátenme Porque Me Muero	Jaguares	El Primer Instinto	spotify:track:3Hp4aweft8n0C45RXk05iU
La Célula Que Explota	Jaguares	El Primer Instinto	spotify:track:0L6xC0b28l9r6GPu5W1jQr
Como Tú	Jaguares	El Primer Instinto	spotify:track:5NzJkaqPFMocuCErnrHHOf
Fin	Jaguares	El Primer Instinto	spotify:track:2jo6L2LBeBrxReXeO0us4C

Alternative Maybe
Fire Woman	The Cult	Sonic Temple	spotify:track:0GyJA0Yn0CcqvHKzeKaVhw
Mexican Radio	Wall Of Voodoo	Mexican Radio	spotify:track:7dOZxMY4U4YZ3eFwOTABXK
Big in Japan	Alphaville	Forever Young	spotify:track:3BZGi1yUqQyCNC868AqUGG
If You Leave - From "Pretty In Pink"	Orchestral Manoeuvres In The Dark	If You Leave	spotify:track:05oFyvdztPdpwSwpoclD4c
Human	The Human League	Crash	spotify:track:537yo062QIz16oQOgxmul3
Round & Round	New Order	Technique	spotify:track:6sKUIDaEBhWa9WrPgqQMCC
I Don't Like Mondays	The Boomtown Rats	The Fine Art Of Surfacing	spotify:track:7JFoeg0arawADjGcz9gBnq
Only Happy When It Rains	Garbage	Garbage (20th Anniversary Deluxe Edition/Remastered)	spotify:track:1IsGA5ceSC4a5nxgAEYnQd
Lips Like Sugar	Echo & the Bunnymen	Echo & the Bunnymen	spotify:track:3Oa8vnNXStoOHLbJwwMEDP
See A Little Light	Bob Mould	Workbook	spotify:track:7LdKMBKthcdBnAqlAIGqCB
Mandinka	Sinéad O'Connor	Lion and the Cobra	spotify:track:6TYckNar2KHob86P5JNETu
Words	Missing Persons	Spring Session M.	spotify:track:2S3flt2KfOpG7JNmtteAAZ
Chains of Love	Erasure	The Innocents	spotify:track:1I0qu4PsBjAHfJHy9wy5AA
I Want Candy	Bow Wow Wow	We Are The '80s	spotify:track:2FMcDUopGfjBh3xMsrm78S
Spirit Of '76	The Alarm	Standards	spotify:track:67kW4bOyiqtqUJehmX4oGb
Beat Surrender	The Jam	The Gift (Deluxe Edition)	spotify:track:4rNgFyEBbLSDQmOa3MZCNQ
Blister In The Sun	Violent Femmes	Violent Femmes	spotify:track:2ugghimAssmeO3YpFIV7mb
Never Say Never	Romeo Void	Warm, In Your Coat	spotify:track:02RkunUrCBLE5J6jY56QH3
That's Entertainment	The Jam	Sound Affects	spotify:track:7MH7TkjQ4RA1vG454dciw0
Bastards of Young - 2008 Remaster	The Replacements	Tim (Expanded)	spotify:track:0ritgEzDOsxbd2IfYX96S9
Slave To Love	Bryan Ferry	Boys And Girls	spotify:track:1c9dnQbOzw01ID7X2IsYOE
The Stand - Long Version	The Alarm	Standards	spotify:track:689Twz3oz1NBQIsLnIvkNx
A Message to You Rudy - 2002 Remaster	The Specials	The Specials (2002 Remaster)	spotify:track:5dRfBz5ZXJc5gZJsNM04nn
Peek-A-Boo	Siouxsie and the Banshees	Peepshow (Remastered And Expanded)	spotify:track:3VkyKA0iCT1ABwaSjb0kpf
Nearly Lost You	Screaming Trees	Singles (Deluxe Version) [Original Motion Picture Soundtrack]	spotify:track:5lqvKus0CohDfnFKrpR2DY
Finest Worksong - Remastered	R.E.M.	Document - 25th Anniversary Edition	spotify:track:0D4lZI5jBVVB1PUqkkZuNa
Down In It	Nine Inch Nails	Pretty Hate Machine	spotify:track:06UVb2bREPv8hvioVkaMvC
Town Called Malice	The Jam	About The Young Idea: The Very Best Of The Jam	spotify:track:4GzCrjBowX9gghAPVzIKiS
Original Sin	INXS	The Very Best Of	spotify:track:3STinUpwNebQI95obNB738
Home	Iggy Pop	Brick By Brick	spotify:track:50mKJolpvGLvDYaelNZhK6
Teen Angst (What The World Needs Now)	Cracker	Cracker	spotify:track:21gRGP5LdIgto8sznRZ7xz
There's No Other Way - 2012 Remaster	Blur	Leisure (Special Edition)	spotify:track:7qk4uPeLpaKhp8lwas1sBb
Ship of Fools	World Party, Anthony Thistlethwaite	Private Revolution	spotify:track:3ndKgw7LvKO7zIk1rgOQJ2
Pale Shelter	Tears For Fears	The Hurting (Deluxe Edition)	spotify:track:3bq6GVy7ol5FdMU0OtKVkz
Sanctify Yourself	Simple Minds	Once Upon A Time (Super Deluxe)	spotify:track:5YIh3K9eF6ymtagIIpprOU
Alex Chilton	The Replacements	Pleased to Meet Me	spotify:track:0xUzr3YfnBzdZa21UNDojX
Pop Song 89 - Remastered	R.E.M.	Green (25th Anniversary Deluxe Edition)	spotify:track:0f7lwf8ahLohUsaMW8GZIO
Cursed Female	Porno for Pyros	Porno For Pyros	spotify:track:3qduQ8xxlZ0dl1QyLttKPS
Dyslexic Heart	Paul Westerberg	The Resterberg	spotify:track:6h0lrpGtRIwbBiPHthDB3o
Weird Science	Oingo Boingo	Dead Man's Party	spotify:track:03AhYPRQeOqG2j54Tdg94E
Fight Like A Brave	Red Hot Chili Peppers	The Uplift Mofo Party Plan	spotify:track:6NeRpRTcFftvt3j1vF4Pcw
True Faith - 2015 Remaster	New Order	Singles (2016 Remaster)	spotify:track:5uyJ7fbjk6xZzt5UL5jcQg
Charlotte Anne	Julian Cope	My Nation Underground	spotify:track:5nGoA43WjD4Z06DUHBEoYV
Party at Ground Zero	Fishbone	The Essential Fishbone	spotify:track:0vyJfb5merhL1NtmrucJaH
Low	Cracker	Kerosene Hat	spotify:track:6ctbCIikHbC6tSOL1rewQX
The Great Commandment	Camouflage	Voices & Images	spotify:track:3TlHXurwKSffEj6vsEEyLb
Charmless Man	Blur	Blur: The Best Of	spotify:track:1lYOlG9ZNtz5p3eSgnMn0Z
Way Down Now	World Party	Goodbye Jumbo	spotify:track:7n0cOijx7XdTk1MKGY8mIa
The Promise	When In Rome	When In Rome	spotify:track:48p5E25cFPanxuwCTmTpuL
Sister Havana	Urge Overkill	Saturation	spotify:track:6E8hhcSnvtevktpFSnHmjK
Walls Come Tumbling Down	The Style Council	Our Favourite Shop	spotify:track:00cn1ynXQhURwsgv69fN0b
My Ever Changing Moods	The Style Council	Cafe Bleu	spotify:track:4vk81xgPsTv0auIZh0cvGK
Somebody to Shove	Soul Asylum	Grave Dancers Union	spotify:track:41TVMXb9THdtTlo2KojUDe
Nemesis	Shriekback	Oil & Gold	spotify:track:2zyt42KZd9NulLNI3USsYC
Head Like A Hole	Nine Inch Nails	Pretty Hate Machine	spotify:track:3ckd4YA4LcD3j50rfIVwUe
Head On	Pixies	Trompe le Monde	spotify:track:3fCTpxEy0XqjeYobsbekHI
Supernova	Liz Phair	Whip-Smart	spotify:track:0xQ8FPMnv2mG9VhTgpxn2R
The Telephone Call - 2009 Remaster	Kraftwerk	Techno Pop (2009 Remaster)	spotify:track:6HjfXak5P4IAXklUu71NZY
Blues from a Gun	The Jesus and Mary Chain	Automatic (Expanded Version)	spotify:track:74fLpgpdOHDz14DUQGfzwR
In The City	The Jam	In The City	spotify:track:250dZY8xYbhHGQpM6bgL52

passed first round
Always the Sun	The Stranglers	Greatest Hits 1977-1990	spotify:track:6q2lHtQwscJJn2gGuv6wdo
Only A Memory	The Smithereens	Green Thoughts	spotify:track:4QlKsURJWveSH9C8pLQKWq

Some Potentials
Nearly Lost You	Screaming Trees	Sweet Oblivion	spotify:track:7qzFXUvBk7lELXuxVREypV
Bad Luck	Social Distortion	Somewhere Between Heaven And Hell	spotify:track:6Y19VBGJBoixg6umIkE7ar
Dyslexic Heart	Paul Westerberg	The Resterberg	spotify:track:6h0lrpGtRIwbBiPHthDB3o
Girlfriend	Matthew Sweet	Girlfriend (Legacy Edition)	spotify:track:338gPBomyqx33wfeF1AGOd
Hit	The Sugarcubes	Stick Around For Joy	spotify:track:2Q2CZbdsJ75Ev1IUmcJmvu
Teen Angst (What The World Needs Now)	Cracker	Cracker	spotify:track:21gRGP5LdIgto8sznRZ7xz
Divine Thing - Remastered	The Soup Dragons	Hotwired (Deluxe / Remastered)	spotify:track:4VJYmTsXG9hAfWFBEJruRK
Helpless	Sugar	Copper Blue (Remastered)	spotify:track:2V6J6aswk9GVgtIkIAq41b
Somebody to Shove	Soul Asylum	Grave Dancers Union	spotify:track:41TVMXb9THdtTlo2KojUDe
Ballad Of Peter Pumpkinhead - 2001 Remaster	XTC	Nonsuch	spotify:track:50GQrTJ85qG7wSPoGjvuCM
Drive	R.E.M.	Automatic For The People	spotify:track:3geRffSf6eAruhg23RkpKV
100%	Sonic Youth	Dirty	spotify:track:5bNpYsNWgvF3kLC54vplp8
Never Say Never	Romeo Void	Warm, In Your Coat	spotify:track:02RkunUrCBLE5J6jY56QH3
Relax	Frankie Goes To Hollywood	Welcome To The Pleasuredome	spotify:track:2K22nUTdyr48JDwI5t906t
The Stand	The Alarm	Declaration (30th Anniversary)	spotify:track:0BgFsTR0kaIs1U1anKbINa
Rescue Me - Remastered	The Alarm	Eye of the Hurricane (1987-1988 Remastered)	spotify:track:11OB69UJFALaAHshUFrlOB
Peace Train	10,000 Maniacs	Campfire Songs: The Popular, Obscure and Unknown Recordings of 10,000 Maniacs	spotify:track:1w55KYUy9raksnb56nvScq
Ship of Fools	World Party, Anthony Thistlethwaite	Private Revolution	spotify:track:3ndKgw7LvKO7zIk1rgOQJ2
Runaway Train	Soul Asylum	Grave Dancers Union	spotify:track:3TW48DvQ7ChwY1Yy1tkMaP
Wasteland	The Mission	Gods Own Medicine	spotify:track:4kiVRcINxpbNTbmEbePXQL
Daydreaming	Massive Attack	Singles Collection	spotify:track:6h42lTGn9jDlfgJbNrxHdL
The Only One I Know	The Charlatans	Some Friendly	spotify:track:17hdos7cv1vAvcfoTU4Pym
Standing There	The Creatures	Boomerang	spotify:track:5r4LWf5wOdYRscFeMPQPAF
Welcome To The Cheap Seats	The Wonder Stuff	Never Loved Elvis	spotify:track:0f1fgVft3lSFiUWTvtKnV0
Words	Missing Persons	Spring Session M.	spotify:track:2S3flt2KfOpG7JNmtteAAZ
In The Days Of The Caveman	Crash Test Dummies	God Shuffled His Feet	spotify:track:5PPFqY21IYzuucFit2kvVr
Hunger Strike	Temple Of The Dog	Temple Of The Dog	spotify:track:0W7AbEauB7cP4pidLclApe
Straight to You - 2010 Remastered Version	Nick Cave & The Bad Seeds	Henry's Dream (2010 Remastered Version)	spotify:track:3ZMQOrCj7exXxV7NmCiorW
Do You Love Me? - 2011 Remastered Version	Nick Cave & The Bad Seeds	Let Love In (2011 Remastered Version)	spotify:track:26sLRGYCSYSnK0cJVtcCAf
White Noise	The Living End	BBQ Songs	spotify:track:2N1kQSIn1pIbf49exRou7N
Prisoner of Society	The Living End	The Living End	spotify:track:2HY0xuuAqkGAlocHJ2Plu3
All Torn Down	The Living End	The Living End	spotify:track:7wExJtAgOuF21fMxUwyIsB
Second Solution	The Living End	The Living End	spotify:track:1kj3ASwCuqDnzehRd3WIz3
End of the World	The Living End	MODERN ARTillery (U.S. Version)	spotify:track:7z4DarPmWybFV4LUgx2Bot
Carry Me Home	The Living End	Roll On	spotify:track:1zTtpTKjk7RsMBx9ybrAqP
Roll On	The Living End	Roll On	spotify:track:6Mb0pYlBzfKngcNuOs5UFZ
Wake Up	The Living End	State of Emergency	spotify:track:3LrmESrQvVrPWmz8hjbIee
West End Riot	The Living End	The Living End	spotify:track:56X1106MCLMjHhBF4qPEwk
Save the Day	The Living End	The Living End	spotify:track:542di2pc4TrCoIpfBaucc4
Bull In The Heather	Sonic Youth	Experimental Jet Set, Trash And No Star	spotify:track:6px1KhTqAfxdcF6A1JGSpx
More Than This	Roxy Music	Avalon	spotify:track:6N7gPTru90HYLRUIVDQ185
The Space Between	Roxy Music	Avalon	spotify:track:45UhvXm5P2bXBJfmG4h0yW
Avalon	Roxy Music	Avalon	spotify:track:7iWIdiJlKvJ4PjFYVrWLUU
India	Roxy Music	Avalon	spotify:track:2mFQ1UwlVpbzHSDv0qnioP
While My Heart Is Still Beating	Roxy Music	Avalon	spotify:track:1fcz0bjCaoAo4APleIRTut
The Main Thing	Roxy Music	Avalon	spotify:track:0jVedBb3lT4SYV77zrDdeQ
Take A Chance With Me	Roxy Music	Avalon	spotify:track:1i7udkWd7YzALjdYQnzqvM
To Turn You On	Roxy Music	Avalon	spotify:track:0y74BqFLkaMbhZtywFJ1I4
True To Life	Roxy Music	Avalon	spotify:track:78xp7CjJ3Uqxa44QAMdBWJ
Tara	Roxy Music	Avalon	spotify:track:5oMNDwCx1Lr9BSL4WkkazM
The Mercy Seat - 2010 Remastered Version	Nick Cave & The Bad Seeds	Tender Prey (2010 Remastered Version)	spotify:track:4B9x0sAKWEISGyu4N4ti8u

Clips
На дне	Molchat Doma	Этажи	spotify:track:6gByMgGv9YG1xXjw7DitRv
Клетка	Molchat Doma	Этажи	spotify:track:6WAfQig9RO3vdGfT03difJ
Тоска	Molchat Doma	Этажи	spotify:track:3MkFYlwM2oiweWGyNw8oGt
Фильмы	Molchat Doma	Этажи	spotify:track:4j6ABX3Et5cHfRZ7qk3KW4
A Private Understanding	Protomartyr	Relatives In Descent	spotify:track:7BVk87ORFR4imfNwHOFPs2
Half Sister	Protomartyr	Relatives In Descent	spotify:track:6zbFlDUqDdLbHikceCg64h
The Chuckler	Protomartyr	Relatives In Descent	spotify:track:0LeG6rLnZikAoLQMhSNSBW
Maidenhead	Protomartyr	Under Color of Official Right	spotify:track:4KiDXFDLZ7SJvVDKrq3r8k
Unconscious Melody	Preoccupations	Cassette	spotify:track:58ITGKThH6gQ4qfkir8kKb
Continental Shelf	Preoccupations	Viet Cong	spotify:track:3d5lGpqxg1cMEYrgTaGxZy
Disarray	Preoccupations	New Material	spotify:track:2QlYpno65G6IJ2X3Yp4V9L
Silhouettes	Preoccupations	Viet Cong	spotify:track:07cUDeewEa1wMfKHUakxtK
Bunker Buster	Preoccupations	Viet Cong	spotify:track:7rqZJ8JM8nlNHb4p8eCSTR
Tenderness	Parquet Courts	Wide Awake!	spotify:track:2wF5p2dfUbEiqAnCRVNwmK
Total Football	Parquet Courts	Wide Awake!	spotify:track:5fsfk1Oogb99koL8wyzomw
Freebird II	Parquet Courts	Wide Awake!	spotify:track:3GAKdDYtNBhC6jFx9hzQfA
Almost Had to Start a Fight/In and Out of Patience	Parquet Courts	Wide Awake!	spotify:track:0QAEc5JBdaZMdxqU3xL64H
Pain Killer	Iceage, Sky Ferreira	Beyondless	spotify:track:2V4U5hZOUnY1jzhNZpcrAD
Against the Moon	Iceage	Plowing Into the Field of Love	spotify:track:3boTvdeBx7IeK16oIheGks
The Lord's Favorite	Iceage	Plowing Into the Field of Love	spotify:track:4I2LbmU2yiY2p6m5gJRcRy
Catch it	Iceage	Beyondless	spotify:track:7hlrsvEHB1oiWuoTVpdvKG
Hurrah	Iceage	Beyondless	spotify:track:0KXPx2e7up8Fl7wWjKWOJj
Jj	Priests	Nothing Feels Natural	spotify:track:5pmswGf4fU7jQq7SlpLK1M
Suck	Priests	Nothing Feels Natural	spotify:track:6dqmBsb7lEWvecQjMpwpkY
Nothing Feels Natural	Priests	Nothing Feels Natural	spotify:track:7jFM0wZch8oJVRVQMl2nvV
The Seduction of Kansas	Priests	The Seduction of Kansas	spotify:track:249eZZvOoV1mFb5WF3dBv7
And Breeding	Priests	Bodies and Control and Money and Power	spotify:track:2AD0AAd4bIU6sLOVGkdejy
Adore	Savages	Adore Life	spotify:track:43v9n2WUgrDi4Z4wiEEV8h
Husbands	Savages	Silence Yourself	spotify:track:1Wq2ujMsdwMHDBkG1aCYCv
The Answer	Savages	Adore Life	spotify:track:78s60WtjgHdcqmeQu835vJ
Surrender (Trentemøller Remix)	Savages	Surrender (Trentemøller Remix)	spotify:track:2UGLwTvRN0CHLAhVlcBjCs
Shut Up	Savages	Silence Yourself	spotify:track:12RC8PzvADK34H7DoyD8GH
Annihilator	Night Sins	Portrait in Silver	spotify:track:5hnbT7970Dw2BRHBlEiCGN
Down to Drown	Night Sins	Down to Drown	spotify:track:6HRSqupTXv6lUwr5TnSPnK
Crystal Blue	Night Sins	Dancing Chrome	spotify:track:0330FKCHzvLohx7ab55R2P
Lonely in the Mirror	Night Sins	Portrait in Silver	spotify:track:65NJErmidWsKZ4AWGDylSp
Who Made The Man?	Uranium Club	All Of Them Naturals	spotify:track:7ib5NOykP6HOG6VdjeS6qz
Opus	Uranium Club	All Of Them Naturals	spotify:track:2Miap882SbE8Ms89ONapNH
That Clown's Got A Gun	Uranium Club	All Of Them Naturals	spotify:track:4yjlM9f8HSeUc9qWVTrKd2
Sun Belt	Uranium Club	Human Exploration	spotify:track:2rHXkELXbNjD5TmdgWHi70
Grease Monkey	Uranium Club	The Cosmo Cleaners	spotify:track:0W7555EiwIl7jaSftUBJb8
The Next Fix	Crack Cloud	The Next Fix	spotify:track:4jm9SW9UWzzZ8SIJjYjjCA
Philosopher's Calling	Crack Cloud	Crack Cloud	spotify:track:2rZga21fzRxkArQ07PbimN
Time Unsubsidized	Crack Cloud	Crack Cloud	spotify:track:6gMc9GPAttsyW68GVb0FHb
P T L (Post Traumatic Love)	ACTORS	P T L (Post Traumatic Love) - Single	spotify:track:4BvPHIhf8q9T6wLNtUWBU2
Face Meets Glass	ACTORS	It Will Come to You	spotify:track:7a7G6UxSuYRF7kIaCPAYRT
We Don't Have to Dance	ACTORS	It Will Come to You	spotify:track:0USzpwZZIeqWC4cQUf18ck
It Goes Away	ACTORS	It Goes Away	spotify:track:2kVOzV7gKA5Zw31tFQi3e2
Slaves	ACTORS	It Will Come to You	spotify:track:1AnRrw880yjGXFWoKhQtu0
The Last Train's Come and Gone	Cindy Lee	Act of Tenderness	spotify:track:1438FzaDW0V4T9jys3eRwX
Always Lovers	Cindy Lee	Malenkost	spotify:track:6pOO4LRe594Ry898Be5HmI
Power and Posession	Cindy Lee	Act of Tenderness	spotify:track:4RMx5oPJ9vhLWzqHQGZiDH
Operation	Cindy Lee	Act of Tenderness	spotify:track:55QUCjrTjJtrTYJFg3zcmY
Dry Dive	Cindy Lee	Model Express	spotify:track:2qrejFX0fFbE2Mq1ZGXSvr
Nose Picker	Negative Scanner	Nose Picker	spotify:track:6n1zgrr2GRTGNWyG8gv8se
T.V.	Negative Scanner	Nose Picker	spotify:track:7H01gz5N7iQpJq78KBzTip
Low	Negative Scanner	Negative Scanner	spotify:track:3LDMTzb5rGJRZsPmyPRD2a
History Lesson	Negative Scanner	Nose Picker	spotify:track:4qCbjsg5AtMnj2wTnbbnVz
Shoplifter	Negative Scanner	Nose Picker	spotify:track:1dt82JdJEL5OmmTi6EnWHv
Durdu Dünya	She Past Away	Disko Anksiyete	spotify:track:0rXcRGePzt2vuBjTQnshsL
Asimilasyon	She Past Away	Narin Yalnizlik	spotify:track:513Btbko3502Gth1g7Seyj
Ritüel	She Past Away	Belirdi Gece	spotify:track:53STwUcy9VxTLyAVLLGQyy
Disko Anksiyete	She Past Away	Disko Anksiyete	spotify:track:0jCpXJNy6RMIVvsvQjquHz
Excuse Generator	Lithics	Mating Surfaces	spotify:track:0c3YWBPsNzyREE1rO0LaVl
Specs	Lithics	Mating Surfaces	spotify:track:6xE3vkaDsZ9fvpzTG7XR09
Edible Door	Lithics	Mating Surfaces	spotify:track:7vPVgaStuMnrVSiNfkbmpU
Glass of Water	Lithics	Mating Surfaces	spotify:track:5CdNvYunpWeVJmjC1DLI3G

Post Punk 2k
Beautiful Blue Sky	Ought	Sun Coming Down	spotify:track:2lp3ycHVNMK2xZ5GFMwEtX
Strong Enough	Porridge Radio, Piglet	Let’s Not Fight ! b/w Strong Enough	spotify:track:3zCp3vtCQD11S9VyqHVQlN
Girls & Boys	Viagra Boys	Girls & Boys	spotify:track:4Xt5Zpuk3AGXfojsWJP23l
Theme from Krill	Krill	Lucky Leaves	spotify:track:67ttNRUJGWnjeLOQjCtMSV
Narrator - Edit	Squid, Martha Skye Murphy	Narrator	spotify:track:0kU1dKmPqpSjHBMQ0lU9z1
Southbound Station	Omni	Multi-task	spotify:track:2XJRjW5xk9SluEBqsjuBK6
Disarray	Preoccupations	New Material	spotify:track:2QlYpno65G6IJ2X3Yp4V9L
Nothing Feels Natural	Priests	Nothing Feels Natural	spotify:track:7jFM0wZch8oJVRVQMl2nvV
These Are Not Your Memories	TVAM	These Are Not Your Memories	spotify:track:3IibriQcR33GG9ZDkBdLiT
Total Football	Parquet Courts	Wide Awake!	spotify:track:5fsfk1Oogb99koL8wyzomw
Magic of Meghan	Dry Cleaning	Magic of Meghan	spotify:track:2aLK2WqtkW4pkBh8wH3lUn
One Rizla	shame	Songs of Praise	spotify:track:2ibdYmH7GRHNnUcBa6kbnG
Stick	Ovlov	TRU	spotify:track:3MM4P4bSI9aihs5hVYPzYt
Wired/Weird	Beige Banquet	Beta	spotify:track:6HpelWP42NVal2WShBobNt
Protathlitis	MAZOHA	Protathlitis	spotify:track:3El123DgjXaQvGUDEYD0Pl
Sit Down Meal	Dry Cleaning	Sit Down Meal	spotify:track:2TXt5g2SyO4ZPNcJnVVeCh
Nite Expo	Thee Oh Sees	Orc	spotify:track:4MMUZtRnaz25sXteRs2mXl
She Will	Savages	Silence Yourself	spotify:track:345yzi3WeMTpMTl3Nyvjjk
Hunger for a Way Out	Sweeping Promises	Hunger for a Way Out	spotify:track:4bXsXIRPbTk783vfyA2oRe
Concrete	shame	Songs of Praise	spotify:track:6X7H3JTAUGAL1rSwohnPBX
Pain Killer	Iceage, Sky Ferreira	Beyondless	spotify:track:2V4U5hZOUnY1jzhNZpcrAD
Almost Had to Start a Fight/In and Out of Patience	Parquet Courts	Wide Awake!	spotify:track:0QAEc5JBdaZMdxqU3xL64H
The Hype	Shopping	The Official Body	spotify:track:7zgfVkrjf2B9qWE1CUaXyr
Silhouettes	Preoccupations	Viet Cong	spotify:track:07cUDeewEa1wMfKHUakxtK
Water in the Well	shame	Water in the Well	spotify:track:38UnguvFOM6pfME9l9zig4
Sunglasses - Edit	Black Country, New Road	Sunglasses	spotify:track:449tx8bd5PFEw5dT0KPpLz
Fruit	Pill	Fruit	spotify:track:0cd8BhLPz3ZyJSkfuD4bN1
Processed By The Boys	Protomartyr	Processed By The Boys	spotify:track:5iOgwvHcgvW7EMaMDt79aT
Letter	Dehd	Letter	spotify:track:0FOtDyR1nTN9vMQs0jVGeU
The Cleaner	Squid	The Cleaner	spotify:track:0NCu73bAuBp4tXZFx4DEHJ
Calling It	Automatic	Calling It	spotify:track:1V4GgaXzuPn4lOWtx33crz
Paul	Girl Band	Holding Hands With Jamie	spotify:track:1ulRN20ts4efc3DHKABsVu
Talking Pictures	FRIGS	Basic Behaviour	spotify:track:41rEc1qxuC6RSD9Kmgrokw
Another Night	The Men	Tomorrow's Hits	spotify:track:3x2kMMjAMfZvgV9PacT3Mw
Courtesy Call	Omni	Courtesy Call	spotify:track:3abS9KDClZlCFY7n1g5HEZ
Ecstasy	Iceage	You're Nothing	spotify:track:4CVOzpLvzCkpptq4PURXvi
I Don't Belong	Fontaines D.C.	I Don't Belong	spotify:track:5cROm5vS1sK0gM3NQL5Gr6
Wheel of Fortune	Protomartyr, Kelley Deal	Consolation E.P.	spotify:track:7b8yk8Rnqvfxjr8kJmZqjS
Shiny New Model	BODEGA	Shiny New Model	spotify:track:5Blr6wOtVsOujq4YsTDETf
Goodnight	Dry Cleaning	Goodnight	spotify:track:4p9oD9628pjRospq8ztiCU
Don't Cling To Life	The Murder Capital	Don't Cling To Life	spotify:track:0KWnYZSO5GAzCJrgr4oGNr
Sports	Viagra Boys	Sports	spotify:track:56yeb6zxKn9aNjLyvbs1BM
Nigel Hitter	shame	Nigel Hitter	spotify:track:5sV5xcygaRKdwL48GIvj1a
Sincerely Yours	Omni	Sincerely Yours	spotify:track:681yJhwlkfzPd4ZRc9SUAF
Flying	Dehd	Flower of Devotion	spotify:track:4i2s69U5vRLS0KQtNMAWbb
Stimulus for Living	Drahla	Stimulus for Living	spotify:track:6ZuhUEBqrXxvsrxAymcwzh
Houseplants	Squid	Houseplants	spotify:track:3Q1Q4dftyBYbcCa0YFIhUD
Down in the Basement	Viagra Boys	Street Worms	spotify:track:3EQGADvujDRkbRVBXV0fr8
Who's My Eugene? - Edit	Tropical Fuck Storm	Who's My Eugene? - Edit	spotify:track:5JqeO2yMJNmdgk2B7HPy9i
Jumbo’s	Protomartyr	Jumbo’s	spotify:track:6geZTtlllUBUei0ypRehDt
This Heat	Deeper	This Heat	spotify:track:5zzfwhoMD6rRct8MTyeAFR
Who’s Got Time?	Flasher	Constant Image	spotify:track:6rNIOIuVgJeftM3T0f0AVg
Life Goes On	Beak>	Life Goes On	spotify:track:19PvZLD2TpIzc7JqcTRxa0
South	Wu-Lu, Lex Amor	South	spotify:track:7pMZ71tatoBEvhpM5ZaIS2
Lucky	Dehd	Lucky	spotify:track:4r7cKo2Lp5sD6VcK1Gu3r4

Post-punk audit
Newspaper Spoons	Preoccupations	Viet Cong	spotify:track:4xvEGLCai1xbgUpMlRkxAG
Pointless Experience	Preoccupations	Viet Cong	spotify:track:1Id5XulbhDmhH2vDNTLQiP
March of Progress	Preoccupations	Viet Cong	spotify:track:2L5lWX4pagbHRIMV1YVBy5
Bunker Buster	Preoccupations	Viet Cong	spotify:track:7rqZJ8JM8nlNHb4p8eCSTR
Continental Shelf	Preoccupations	Viet Cong	spotify:track:3d5lGpqxg1cMEYrgTaGxZy
Silhouettes	Preoccupations	Viet Cong	spotify:track:07cUDeewEa1wMfKHUakxtK
Death	Preoccupations	Viet Cong	spotify:track:69izLOjRU2txMIcNghWd0I
The Devil in His Youth	Protomartyr	The Agent Intellect	spotify:track:4gYKox72XEHWLsKHBsPEL5
Cowards Starve	Protomartyr	The Agent Intellect	spotify:track:2GOncz0yupivM8gTNqI0ni
I Forgive You	Protomartyr	The Agent Intellect	spotify:track:4LbYMAWT2ApEARMMjOHxvP
Boyce or Boice	Protomartyr	The Agent Intellect	spotify:track:7HkMMiq88VUWP0Inr5cg8n
Pontiac 87	Protomartyr	The Agent Intellect	spotify:track:2258MfnrxFPlI46lE6f1Iz
Uncle Mother's	Protomartyr	The Agent Intellect	spotify:track:62zxgGLwnoJyZKCmNX2Kjt
Dope Cloud	Protomartyr	The Agent Intellect	spotify:track:7DKStSTQxDrhBmLCOvO6qN
The Hermit	Protomartyr	The Agent Intellect	spotify:track:2wxI72CJ3WQ3SUyNRleXnh
Clandestine Time	Protomartyr	The Agent Intellect	spotify:track:0X7nnlWwGy4Baq7eUpGAoR
Why Does It Shake?	Protomartyr	The Agent Intellect	spotify:track:3Fqgd0BtDJkHrHk4Q2Yq8o
Ellen	Protomartyr	The Agent Intellect	spotify:track:5Zv0ICd6fclpe1rY3K6udM
Feast of Stephen	Protomartyr	The Agent Intellect	spotify:track:03G9uPkT8Xcz6HqrxSPr3n
Total Football	Parquet Courts	Wide Awake!	spotify:track:5fsfk1Oogb99koL8wyzomw
Violence	Parquet Courts	Wide Awake!	spotify:track:5pfERhAfhpscnAKQnZgnaC
Before the Water Gets Too High	Parquet Courts	Wide Awake!	spotify:track:5wpBEy8gYVQmb5VArtayfp
Mardi Gras Beads	Parquet Courts	Wide Awake!	spotify:track:7mVj1R3omIBoyFaMDV0fG4
Almost Had to Start a Fight/In and Out of Patience	Parquet Courts	Wide Awake!	spotify:track:0QAEc5JBdaZMdxqU3xL64H
Freebird II	Parquet Courts	Wide Awake!	spotify:track:3GAKdDYtNBhC6jFx9hzQfA
Normalisation	Parquet Courts	Wide Awake!	spotify:track:51bMZRDRjn3wsLUyyEY08u
Back to Earth	Parquet Courts	Wide Awake!	spotify:track:3NMVmvEQuLx2BFETr5DGFF
Wide Awake	Parquet Courts	Wide Awake!	spotify:track:7COxY38TB5HTeXRAucOEW4
NYC Observation	Parquet Courts	Wide Awake!	spotify:track:0ctBsZVhuR5neBVKhidPLt
Extinction	Parquet Courts	Wide Awake!	spotify:track:2w4IOwRp9CLexehyJN90Md
Death Will Bring Change	Parquet Courts	Wide Awake!	spotify:track:1ovG6NnVterZgBLQdeddOq
Tenderness	Parquet Courts	Wide Awake!	spotify:track:2wF5p2dfUbEiqAnCRVNwmK
Remains	Algiers	Algiers	spotify:track:6Vk3MMnpioe9MYvoQUgjew
Claudette	Algiers	Algiers	spotify:track:302sth2ekZk0Jx3muBGIC8
And When You Fall	Algiers	Algiers	spotify:track:7e5QsZHevWJbjgu3qeKWMz
Blood	Algiers	Algiers	spotify:track:7ldMja9Us2gUrXmIxRWfpl
Old Girl	Algiers	Algiers	spotify:track:3Y8f0jepQZ9Nb6UQcQSzOX
Irony. Utility. Pretext.	Algiers	Algiers	spotify:track:4aWxijBBxw158KTPSUJkTt
But She Was Not Flying	Algiers	Algiers	spotify:track:6AE3lDGWfBLJRyRVbmAHAu
Black Eunuch	Algiers	Algiers	spotify:track:2aNHMMpclCTUBeFRzHmHBy
Games	Algiers	Algiers	spotify:track:51rCZoBe2NdJpSjkBxzISo
In Parallax	Algiers	Algiers	spotify:track:0jdxrVGNCVD9S1HUKabPue
untitled	Algiers	Algiers	spotify:track:1rqF3ZBpMOpURSeMUQFadY
Shut Up	Savages	Silence Yourself	spotify:track:12RC8PzvADK34H7DoyD8GH
I Am Here	Savages	Silence Yourself	spotify:track:21L9PAOKbo9GTDysLscztL
City’s Full	Savages	Silence Yourself	spotify:track:0UE3IEvNmqi7CyUqDZXScU
Strife	Savages	Silence Yourself	spotify:track:1jJE6kIho33FcUZMyxz58m
Waiting for a Sign	Savages	Silence Yourself	spotify:track:2ZzAGE2NKgyo3CLDGYMBeZ
Dead Nature	Savages	Silence Yourself	spotify:track:2GRpkni1WEtryYDAmlScC2
She Will	Savages	Silence Yourself	spotify:track:345yzi3WeMTpMTl3Nyvjjk
No Face	Savages	Silence Yourself	spotify:track:5KTzvBaCjJJeb8uvhAfogq
Hit Me	Savages	Silence Yourself	spotify:track:4OBM2rZSQZas2DfBeWkIla
Husbands	Savages	Silence Yourself	spotify:track:1Wq2ujMsdwMHDBkG1aCYCv
Marshal Dear	Savages	Silence Yourself	spotify:track:1GRminqAAGshlfQTBlwYJ3
On My Fingers	Iceage	Plowing Into the Field of Love	spotify:track:0012gIWzFurw8rjIdNptaS
The Lord's Favorite	Iceage	Plowing Into the Field of Love	spotify:track:4I2LbmU2yiY2p6m5gJRcRy
How Many	Iceage	Plowing Into the Field of Love	spotify:track:0Yge5BCAZfRCjXYTgUrUQ0
Glassy Eyed, Dormant and Veiled	Iceage	Plowing Into the Field of Love	spotify:track:1WX6mFLw5KHCYP7JmZFf4i
Stay	Iceage	Plowing Into the Field of Love	spotify:track:0inCYqLHPpwTKl3vW7KbCk
Let It Vanish	Iceage	Plowing Into the Field of Love	spotify:track:13gzO8HQDJtWzk76y8Kn3s
Abundant Living	Iceage	Plowing Into the Field of Love	spotify:track:5QUDfgFmbbgcBa8FT5CSUu
Forever	Iceage	Plowing Into the Field of Love	spotify:track:0KSONMZo3WQepg0TYylJGD
Cimmerian Shade	Iceage	Plowing Into the Field of Love	spotify:track:49I0v2Wu79zNT1j70AhxUt
Against the Moon	Iceage	Plowing Into the Field of Love	spotify:track:3boTvdeBx7IeK16oIheGks
Simony	Iceage	Plowing Into the Field of Love	spotify:track:1EOHT6EEoafW26jbUOAufK
Plowing Into the Field of Love	Iceage	Plowing Into the Field of Love	spotify:track:2nKa7GvgDgEqQH7qXYBJMn
Air Dance	Night Sins	To London Or the Lake	spotify:track:6m8dDZ7rI6xBBq2WEArX3s
To London Or the Lake	Night Sins	To London Or the Lake	spotify:track:2ARUbLCLdloApdfQcVw3Cb
Evangeline	Night Sins	To London Or the Lake	spotify:track:3wA4TE4l3xEqRsephsvHkk
Rain	Night Sins	To London Or the Lake	spotify:track:20P9lgU4LhwCp9E4uXu839
Bound 'Round the World	Night Sins	To London Or the Lake	spotify:track:6LWlSG6km7P3XzNg3U1DA4
Heaven in the Snow	Night Sins	To London Or the Lake	spotify:track:5CNwAa8uA4QqjGE5aTtNnK
Dear Marquis	Night Sins	To London Or the Lake	spotify:track:6P8Zdv5MpG2KyOfYi0HNyU
Neon Light Intoxicants	Night Sins	To London Or the Lake	spotify:track:2ZIby7MlAymstMNELB4yh8
Dance Yrself Clean	LCD Soundsystem	This Is Happening	spotify:track:2cmRpmO04TLaKPzmAzySYZ
Drunk Girls	LCD Soundsystem	This Is Happening	spotify:track:0IUAugkLGELvtFJfzPn2vi
One Touch	LCD Soundsystem	This Is Happening	spotify:track:6nlmCGmPBYfdKnMpavObQm
All I Want	LCD Soundsystem	This Is Happening	spotify:track:4Cy0NHJ8Gh0xMdwyM9RkQm
I Can Change	LCD Soundsystem	This Is Happening	spotify:track:2073QOEC8rBtSyTsRyaWiP
You Wanted a Hit	LCD Soundsystem	This Is Happening	spotify:track:3fU0407Cls1hLW1ap5w2Lr
Pow Pow	LCD Soundsystem	This Is Happening	spotify:track:3VhBuvzzuGUuh7nyJJvGLk
Somebody's Calling Me	LCD Soundsystem	This Is Happening	spotify:track:4NiwTsBlFT7H2OMpUbadwL
Home	LCD Soundsystem	This Is Happening	spotify:track:5gmv3BgePSYiHnPJgY7oTJ
More of What	Crack Cloud	Crack Cloud	spotify:track:2sI7hOTyqs7VcuSBJNTxii
Drab Measure	Crack Cloud	Crack Cloud	spotify:track:5SQOAXMrAxunWzVTW3oIvP
Time Unsubsidized	Crack Cloud	Crack Cloud	spotify:track:6gMc9GPAttsyW68GVb0FHb
Cap//Cloak	Crack Cloud	Crack Cloud	spotify:track:3BDrnpgDmzMU4M40zKupV8
Bastard Basket	Crack Cloud	Crack Cloud	spotify:track:7AtvJPtUqRsKbnDNDeO53S
Lack of Lack	Crack Cloud	Crack Cloud	spotify:track:5CVC3oArsFQaVHBv4OLYIS
Graph of Desire	Crack Cloud	Crack Cloud	spotify:track:5YVaI6vnv6l5J7q4GYzLx3
Empty Cell	Crack Cloud	Crack Cloud	spotify:track:76FHqYVtY0VomshJYtj4N1
Image Craft	Crack Cloud	Crack Cloud	spotify:track:4J3CrA9m3I6oRiTOQNfVaQ
Philosopher's Calling	Crack Cloud	Crack Cloud	spotify:track:2rZga21fzRxkArQ07PbimN
Swish Swash	Crack Cloud	Crack Cloud	spotify:track:75LA67HCWFpxV5LaiMEPu4
Xyx	ACTORS	Reanimated	spotify:track:6F4bIoYVqpopACVSEn9iPv
How Deep Is the Hole	ACTORS	Reanimated	spotify:track:4i8OLf74MDQaDPDGTdZPM9
Like U Want 2	ACTORS	Reanimated	spotify:track:0PAhQpWo4Y8S0G8P4owVTb
Jacknife	ACTORS	Reanimated	spotify:track:4hFK88uuhVas6Pl6VXwApQ
Flesh & Bone	ACTORS	Reanimated	spotify:track:6oz0mSgSERWuqWJrFYxRSN
Forever	ACTORS	Reanimated	spotify:track:3AzwcA8dCBeA78Wv3OYUoc
Already Dead	Parquet Courts	Human Performance	spotify:track:5E6VidlnFqvmJu3SZmaaqq
Dust	Parquet Courts	Human Performance	spotify:track:0bZDQlvx2oS1NiUZZ1aXGu
Human Performance	Parquet Courts	Human Performance	spotify:track:3iyYmoZMI4o0xW0nCLwAT3
Outside	Parquet Courts	Human Performance	spotify:track:03esnE5CZwxCLie5NedKRo
I Was Just Here	Parquet Courts	Human Performance	spotify:track:6ueKoWHXKBwsnhFjTORjHl
Paraphrased	Parquet Courts	Human Performance	spotify:track:3xdjI4AdnT93n9z7rIe7Tg
Captive of the Sun	Parquet Courts	Human Performance	spotify:track:1bUdQCDuvzb1OBmBfqGqaF
Steady on My Mind	Parquet Courts	Human Performance	spotify:track:2zyXkd7RFLgYyvgsQk9bzi
One Man No City	Parquet Courts	Human Performance	spotify:track:1NdJo2IKt1NkVxAQNfZh47
Berlin Got Blurry	Parquet Courts	Human Performance	spotify:track:7qPK7huRsW7uBsQFTLWZk8
Keep It Even	Parquet Courts	Human Performance	spotify:track:3bPlFZUQ1gY0jhRCTJrrWS
Two Dead Cops	Parquet Courts	Human Performance	spotify:track:5zLaH3gC26RVIa38eHRoFp
Pathos Prairie	Parquet Courts	Human Performance	spotify:track:7xXjg23Rux7Q0hCvsC3QmZ
It's Gonna Happen	Parquet Courts	Human Performance	spotify:track:2HCv4072HhDaOtP3R5FnwR
Hurrah	Iceage	Beyondless	spotify:track:0KXPx2e7up8Fl7wWjKWOJj
Pain Killer	Iceage, Sky Ferreira	Beyondless	spotify:track:2V4U5hZOUnY1jzhNZpcrAD
Under the sun	Iceage	Beyondless	spotify:track:0WhcNje7Vpz83dTXmnGums
The day the music dies	Iceage	Beyondless	spotify:track:6bJao385FumXdxIK8ITi8b
Plead the fifth	Iceage	Beyondless	spotify:track:4PKjqKbXsZ8EYVc07aWACM
Catch it	Iceage	Beyondless	spotify:track:7hlrsvEHB1oiWuoTVpdvKG
Thieves like us	Iceage	Beyondless	spotify:track:5mlXpdwGt3k5iQeBxFEHyy
Take it all	Iceage	Beyondless	spotify:track:0Wt0GOi6XcUiXiKMqkKzlb
Showtime	Iceage	Beyondless	spotify:track:0L4AVLZRe8MAQIsAGWsxGE
Beyondless	Iceage	Beyondless	spotify:track:5w25KECGn4VnvCaPBKUlfc
A Private Understanding	Protomartyr	Relatives In Descent	spotify:track:7BVk87ORFR4imfNwHOFPs2
Here Is The Thing	Protomartyr	Relatives In Descent	spotify:track:18wNLr1R1cD0UD010WEIJp
My Children	Protomartyr	Relatives In Descent	spotify:track:6fd5sPEa5gFBDaQ3mkj7Zd
Caitriona	Protomartyr	Relatives In Descent	spotify:track:3xrQjt12U3dN5YPqqEPHnI
The Chuckler	Protomartyr	Relatives In Descent	spotify:track:0LeG6rLnZikAoLQMhSNSBW
Windsor Hum	Protomartyr	Relatives In Descent	spotify:track:4BrhQxpQz9rkP8E0BDlluP
Don’t Go To Anacita	Protomartyr	Relatives In Descent	spotify:track:5XmmNOaaE9Y6jyMMaxX2TT
Up The Tower	Protomartyr	Relatives In Descent	spotify:track:6PT7rwuJ7VRa40Qad2pw9B
Night-Blooming Cereus	Protomartyr	Relatives In Descent	spotify:track:69fTwCV254As5JMpa8rlSz
Male Plague	Protomartyr	Relatives In Descent	spotify:track:5xsMey4SLi6Ir8DQgBrDYe
Corpses In Regalia	Protomartyr	Relatives In Descent	spotify:track:6vyxUUHQQkguxWp3bH1JZZ
Half Sister	Protomartyr	Relatives In Descent	spotify:track:6zbFlDUqDdLbHikceCg64h
Act of Tenderness	Cindy Lee	Act of Tenderness	spotify:track:26bNppayJcMtcKmk3GLWxa
Power and Posession	Cindy Lee	Act of Tenderness	spotify:track:4RMx5oPJ9vhLWzqHQGZiDH
What I Need	Cindy Lee	Act of Tenderness	spotify:track:56AHOyzwB9UHnCdAwsaTux
New Romance	Cindy Lee	Act of Tenderness	spotify:track:2Y7rrhdPrxVzdsCvV7VVor
The Last Train's Come and Gone	Cindy Lee	Act of Tenderness	spotify:track:1438FzaDW0V4T9jys3eRwX
Operation	Cindy Lee	Act of Tenderness	spotify:track:55QUCjrTjJtrTYJFg3zcmY
Quit Doing Me Wrong	Cindy Lee	Act of Tenderness	spotify:track:2avMdD4xUh400Qa6qsOGIF
Fallen Angel	Cindy Lee	Act of Tenderness	spotify:track:32aFKBkBfcBRlk6ys1SUrD
Bonsai Garden	Cindy Lee	Act of Tenderness	spotify:track:0EKlp44oYo4f7IPMFuWwAy
Miracle of the Rose	Cindy Lee	Act of Tenderness	spotify:track:1mZmQUijIU8sJ0skea5kiI
Wandering and Solitude	Cindy Lee	Act of Tenderness	spotify:track:7zfUtkVoKFib5Y8romTeVh
A New Love Is Believing	Cindy Lee	Act of Tenderness	spotify:track:5frkSWLXq5enbmGdgZIZ5z
Introduction	Uranium Club	All Of Them Naturals	spotify:track:0ixa7hOenvqfHYe2Rh6ZIb
That Clown's Got A Gun	Uranium Club	All Of Them Naturals	spotify:track:4yjlM9f8HSeUc9qWVTrKd2
The Lottery	Uranium Club	All Of Them Naturals	spotify:track:76r8GMCfAFttfKqvTKH623
God's Chest	Uranium Club	All Of Them Naturals	spotify:track:7ys9JxHIV3QlJXPDQ6vbkc
Who Made The Man?	Uranium Club	All Of Them Naturals	spotify:track:7ib5NOykP6HOG6VdjeS6qz
Opus	Uranium Club	All Of Them Naturals	spotify:track:2Miap882SbE8Ms89ONapNH
Operation Pt.II	Uranium Club	All Of Them Naturals	spotify:track:1j2wtYGvaWQsP14bPQz6P7
Teen Man's Lament - excerpt	Uranium Club	All Of Them Naturals	spotify:track:4sI2gnLmwFsBMHgX1hYj4y
Appropriate	Priests	Nothing Feels Natural	spotify:track:1SgD8T9738K5lGMyEwMHYR
Jj	Priests	Nothing Feels Natural	spotify:track:5pmswGf4fU7jQq7SlpLK1M
Nicki	Priests	Nothing Feels Natural	spotify:track:6xUiSrfHyzwYCVsxxfrc2P
Lelia 20	Priests	Nothing Feels Natural	spotify:track:6iaIKOaT79bNZa8iEx0qHp
No Big Bang	Priests	Nothing Feels Natural	spotify:track:5QSF5hMYna0xcXXoqzWLlS
Interlude	Priests	Nothing Feels Natural	spotify:track:0vq8bM18lQF7Crt00z1fTc
Nothing Feels Natural	Priests	Nothing Feels Natural	spotify:track:7jFM0wZch8oJVRVQMl2nvV
Pink White House	Priests	Nothing Feels Natural	spotify:track:6kO7G3XaignQqeTGOhGphb
Puff	Priests	Nothing Feels Natural	spotify:track:3AcNYyKoy6JzzRLpp8QOAE
Suck	Priests	Nothing Feels Natural	spotify:track:6dqmBsb7lEWvecQjMpwpkY
Ivy League Asshole	Negative Scanner	Negative Scanner	spotify:track:4hFIIYIfioYFOrL0uD5Ozg
Criticism	Negative Scanner	Negative Scanner	spotify:track:24OqtHeKz8ELLCZt4GxDIH
Low	Negative Scanner	Negative Scanner	spotify:track:3LDMTzb5rGJRZsPmyPRD2a
Gone Wild	Negative Scanner	Negative Scanner	spotify:track:3yPANq259i3UZDpK2xi8po
C.P.D.	Negative Scanner	Negative Scanner	spotify:track:0Krtnryc3am86vqieMEQqn
Would You Rather?	Negative Scanner	Negative Scanner	spotify:track:4XmVNkEWuvZbx1Hy1owGot
Planet of Slums	Negative Scanner	Negative Scanner	spotify:track:2hrVFfM7rSECDGxrYAqMwk
Saturday Night & Sunday Morning	Negative Scanner	Negative Scanner	spotify:track:53jhxBUTZZRlk8DFZB6cfr
Fan vs. Wild	Negative Scanner	Negative Scanner	spotify:track:2C0XN2w4jJOmHfAXa7mRd2
Forget It	Negative Scanner	Negative Scanner	spotify:track:2Dk2UOwXDtLX3mmlgPNBH7
Pity	Negative Scanner	Negative Scanner	spotify:track:0WmdN2KjdNPmHVuZSpZXg0
Zemmoa	Ritual Howls	Turkish Leather	spotify:track:2ZFnODVj4zIzmq3CXMxSeI
The Taste of You	Ritual Howls	Turkish Leather	spotify:track:2o7cvthqhKR716dsRDFZA2
Take Me Up	Ritual Howls	Turkish Leather	spotify:track:21ui6UJa9iD976uKuXQPQ8
My Friends	Ritual Howls	Turkish Leather	spotify:track:05Fzd6GfqChpctfv0bnxdj
Final Service	Ritual Howls	Turkish Leather	spotify:track:53Sdzt2zyRHi616EpE6hbQ
Helm	Ritual Howls	Turkish Leather	spotify:track:2uhAz4Ev5bfeHLL32ibxUz
No Witnesses	Ritual Howls	Turkish Leather	spotify:track:791wiJAznqgd1Y7RbvpX9Z
Turkish Leather	Ritual Howls	Turkish Leather	spotify:track:2x5Dgk64HkDd7oaFnlVTIl
I'd Rather Not (Bonus Track)	Ritual Howls	Turkish Leather	spotify:track:0eFqtmxGSuRbVmFJnYSuwh
In My Sphere	Protomartyr	No Passion All Technique	spotify:track:7luQTlSASDBYb38kDOj6SJ
Machinist Man	Protomartyr	No Passion All Technique	spotify:track:4y7fzWEMM19WS4uk8yfLlS
Hot Wheel City	Protomartyr	No Passion All Technique	spotify:track:7HrG60wYpUBtrdOBUWvaiW
3 Swallows	Protomartyr	No Passion All Technique	spotify:track:5CUN5mAhZrhwdEo3kT7xC1
Free Supper	Protomartyr	No Passion All Technique	spotify:track:6IgdxB2hvSEwdl3Tg3Pb80
Jumbo’s	Protomartyr	No Passion All Technique	spotify:track:1e2cMIlvienZ0pCdHeAApN
Ypsilanti	Protomartyr	No Passion All Technique	spotify:track:76i7txeo4Jf58pYLzQyfDt
Too Many Jewels	Protomartyr	No Passion All Technique	spotify:track:1aMhPIaXKHthOXKTzROsS6
(Don’t You) Call Me Out My Name	Protomartyr	No Passion All Technique	spotify:track:6sajw0Ye7W8hCBxmGL8qkW
How He Lived After He Died	Protomartyr	No Passion All Technique	spotify:track:2Ks7xO3x55TptPOZwRjdUV
Feral Cats	Protomartyr	No Passion All Technique	spotify:track:0fBbz92P4UUsPeSq7XfENe
Wine of Ape	Protomartyr	No Passion All Technique	spotify:track:5S2qv4vo8yxFX5wM0hdPOF
Principalities	Protomartyr	No Passion All Technique	spotify:track:6qRlAL9ZzamlWfbOygOLi8
King Boots - Bonus Track	Protomartyr	No Passion All Technique	spotify:track:0O2Fv0TfSPc1domXJFSEj0
Bubba Helms - Bonus Track	Protomartyr	No Passion All Technique	spotify:track:6QVyXcOb8x22SssdrhxnEh
Cartier E.G.s - Bonus Track	Protomartyr	No Passion All Technique	spotify:track:5h6snF0Oc9r12VICg3BXFB
Whatever Happened to the Saturn Boys? - Bonus Track	Protomartyr	No Passion All Technique	spotify:track:2aUgyVaD5m7hi0Sqam3frw
From This Point On	Soft Kill	An Open Door	spotify:track:3Jh0aFJjoFTgXxx7Ht5XRn
Death in the Family	Soft Kill	An Open Door	spotify:track:4unx56UOR6V483VRKPJrmU
Borders Comfort	Soft Kill	An Open Door	spotify:track:4MWZNQsatwoR268sUR2cKh
Feral Moans	Soft Kill	An Open Door	spotify:track:2PMzsOQAhLC0sFI1hQGAF5
Sea of Doubt	Soft Kill	An Open Door	spotify:track:3GXjHYDOVHr2N817MF67CM
Be Alone	Soft Kill	An Open Door	spotify:track:7lXsqw49XWREVk19n7M0mP
An Open Door	Soft Kill	An Open Door	spotify:track:4oxmxfnsXuuLMsRUzJQIcM
Within This Mess	Soft Kill	An Open Door	spotify:track:7lSVLk4XkU24Psm2BPHywk
Surrender	Soft Kill	An Open Door	spotify:track:5iAPlJNjpvLV7zU8ISkaR2
Breathe the Fire	The Soft Moon	The Soft Moon	spotify:track:7qLDBd5iCh9xilyfdkn9v8
Circles	The Soft Moon	The Soft Moon	spotify:track:0PKFAInGnsYZVxX45LtbkP
Out of Time	The Soft Moon	The Soft Moon	spotify:track:6e4oLt19vJzazqVauH7F8u
When It's Over	The Soft Moon	The Soft Moon	spotify:track:3Q6motjDfQGC684NYjddle
Dead Love	The Soft Moon	The Soft Moon	spotify:track:5pIGSQenxOpJtkAxeLf6kh
Parallels	The Soft Moon	The Soft Moon	spotify:track:10VKzaFT33ATqADbkyAKW7
We Are We	The Soft Moon	The Soft Moon	spotify:track:3JLvRjiRIjYGl8KEBBj6Nr
Sewer Sickness	The Soft Moon	The Soft Moon	spotify:track:64rQNOT1AcFa6wkxKX3I6u
Into the Depths	The Soft Moon	The Soft Moon	spotify:track:6S6SoAQ0oOw0uUzA6NONQp
Primal Eyes	The Soft Moon	The Soft Moon	spotify:track:6tajV9FUvh77qJO6XXeEuy
Tiny Spiders	The Soft Moon	The Soft Moon	spotify:track:0ciTVtWQXg38sTCTHiBEyB
Excuse Generator	Lithics	Mating Surfaces	spotify:track:0c3YWBPsNzyREE1rO0LaVl
Still Forms	Lithics	Mating Surfaces	spotify:track:6YQcM5hxz7goKHaVZzSmD8
When Will I Die	Lithics	Mating Surfaces	spotify:track:3iN4w9o9lKMB623PiHBElT
Specs	Lithics	Mating Surfaces	spotify:track:6xE3vkaDsZ9fvpzTG7XR09
Boyce	Lithics	Mating Surfaces	spotify:track:21VuqhueakZPa7rrJxIwL2
Glass of Water	Lithics	Mating Surfaces	spotify:track:5CdNvYunpWeVJmjC1DLI3G
Be Nice Alone	Lithics	Mating Surfaces	spotify:track:7Jnby1lRjQx0pmyK5oVosA
Flat Rock	Lithics	Mating Surfaces	spotify:track:1OjBHeuFiNcMHk9jpcWaNG
Edible Door	Lithics	Mating Surfaces	spotify:track:7vPVgaStuMnrVSiNfkbmpU
Home	Lithics	Mating Surfaces	spotify:track:50jAMtFyYhl8xN2P31wn9a
Cheryl	Lithics	Mating Surfaces	spotify:track:6QohFyajYOWOOUstl4FHf5
Dancing Guy	Lithics	Mating Surfaces	spotify:track:36aR9kl8pY6hNUdu6fmpps
Grandview	Soft Kill	Heresy	spotify:track:7eUAhw5JOXT8mgxO3I4R3c
Violent Mind	Soft Kill	Heresy	spotify:track:5ww5tdaMY8ZDKUD8hNS1Ok
Hit the Floor	Soft Kill	Heresy	spotify:track:61l3CWHpOECvhiMjPNmBMs
Selfish Love	Soft Kill	Heresy	spotify:track:6oxR0YhD1E95H7unPW4eWj
Current	Soft Kill	Heresy	spotify:track:7c3XxoRBrDLIzBFlCxrtEm
Heresy	Soft Kill	Heresy	spotify:track:23N8wbVS21hJmNKXWBCHUW
Soluk	She Past Away	Narin Yalnizlik	spotify:track:0JR4HyI7kUmN7FvEfk8BOi
Asimilasyon	She Past Away	Narin Yalnizlik	spotify:track:513Btbko3502Gth1g7Seyj
Uzakta	She Past Away	Narin Yalnizlik	spotify:track:2N59G0hVDQpB4EB6AQWDfb
Narin Yalnizlik	She Past Away	Narin Yalnizlik	spotify:track:4hVw2ll7lpq715Xhgs3txs
Hayaller	She Past Away	Narin Yalnizlik	spotify:track:6Z9rbccTZxsP9yIiF6QeOD
Katarsis	She Past Away	Narin Yalnizlik	spotify:track:3L4hrj9OrnF0dK0Di4se6G
Uçtu Belirsizliǧe	She Past Away	Narin Yalnizlik	spotify:track:4vtYPqS0OzmufOBjht0Olf
Gerçekten Özleyince	She Past Away	Narin Yalnizlik	spotify:track:4PdGpQ3FXB0OKM4KFrMINj
Yanimda	She Past Away	Narin Yalnizlik	spotify:track:3m25UcpieYIWdLYierBNiX
Kuruyordu Nehir	She Past Away	Narin Yalnizlik	spotify:track:4uzIfvmPvh8AqNcmtbnA4S
Içe Kapanis II	She Past Away	Narin Yalnizlik	spotify:track:3TQEOwydFKeGHRc4yE8Loy
Sanri	She Past Away	Belirdi Gece	spotify:track:1OPgcgaKesmGzx7q7ZeoNj
Ritüel	She Past Away	Belirdi Gece	spotify:track:53STwUcy9VxTLyAVLLGQyy
Monoton	She Past Away	Belirdi Gece	spotify:track:58f1CrfH7TXEV54SyxxIvL
Kasvetli Kutlama	She Past Away	Belirdi Gece	spotify:track:5dB7A7tdmRHlRgZAEvfIdl
Insanlar	She Past Away	Belirdi Gece	spotify:track:3twN5nE5Yspyybn4WYhxzB
Belirdi Gece - Musallat	She Past Away	Belirdi Gece	spotify:track:2gMRhR3GQ902eqax1l02A3
Ruh	She Past Away	Belirdi Gece	spotify:track:0s3uCUtZsslcr7CmH4hNAQ
Kemir Beni	She Past Away	Belirdi Gece	spotify:track:3G2M4S6YouZDFyvdyRBKIE
Bozbulanik	She Past Away	Belirdi Gece	spotify:track:4xqOyRGHzQxDMctUPTGQQa
Ice Kapanis	She Past Away	Belirdi Gece	spotify:track:7gfJJpDjVnI853ZyOxUsuj
Dalej	Belgrado	Obraz	spotify:track:1qOEztArC70zKmQB7xBUSq
1000 Spektakli	Belgrado	Obraz	spotify:track:4GT2XjrwoKelGn6eQrNhLV
Wiatr	Belgrado	Obraz	spotify:track:1OrAdvYhwH2iwjshgJATXt
Kulminacja Oddzielenia	Belgrado	Obraz	spotify:track:7nok2bSsGAB0vhTZTDBJfR
Krajobraz	Belgrado	Obraz	spotify:track:6mju32vEl6TuWkSORr8OJJ
Raz Dwa	Belgrado	Obraz	spotify:track:79xo7AViAxvFWwBRgtac4I
Nierealne Realne Społeczeństwo	Belgrado	Obraz	spotify:track:532aT1ERVsVaoFb1633ck9
Na Ten Czas	Belgrado	Obraz	spotify:track:4Vh0jZYWP1lom0bA4IA0pv
Pasaż	Belgrado	Obraz	spotify:track:07ANY67jcP25f8OQjk4hfp
Fragmenty Świata	Belgrado	Obraz	spotify:track:1QnNl2JhyOBtHJTRI6HS0y
oh baby	LCD Soundsystem	american dream	spotify:track:1Y5EqnpZLLoAp4RQQTr10O
other voices	LCD Soundsystem	american dream	spotify:track:0nTW4n6goPkpnoaBBeSjXm
i used to	LCD Soundsystem	american dream	spotify:track:404ZIfgGYd8VnwUn0HA1Pd
change yr mind	LCD Soundsystem	american dream	spotify:track:0My2pMmVxevwrGyd1CR8u2
how do you sleep?	LCD Soundsystem	american dream	spotify:track:3ETW8l9FuVFpPHUSTyZDK4
tonite	LCD Soundsystem	american dream	spotify:track:2iQov70C2Cs6KCu8Dk8wW1
call the police	LCD Soundsystem	american dream	spotify:track:5rhgZSkr7P8ZNx7OxBbdOw
american dream	LCD Soundsystem	american dream	spotify:track:37sZCRrGMdDsYg7QqqvdnR
emotional haircut	LCD Soundsystem	american dream	spotify:track:0cxDKzFxhhYj2EYAxKsHwB
black screen	LCD Soundsystem	american dream	spotify:track:6kKXowSTq8uKZhdFPdG9BS
pulse (v.1)	LCD Soundsystem	american dream	spotify:track:3HEHSCGLO452rRpPkHQkYy
На дне	Molchat Doma	Этажи	spotify:track:6gByMgGv9YG1xXjw7DitRv
Танцевать	Molchat Doma	Этажи	spotify:track:4fh5h5cF1s7WPiQC4ikCiZ
Фильмы	Molchat Doma	Этажи	spotify:track:4j6ABX3Et5cHfRZ7qk3KW4
Волны	Molchat Doma	Этажи	spotify:track:4Y0gNCWGqYvXFtF64HNkJj
Тоска	Molchat Doma	Этажи	spotify:track:3MkFYlwM2oiweWGyNw8oGt
Прогноз	Molchat Doma	Этажи	spotify:track:5fAxN80Jj1waFXrSzXqFHO
Судно (Борис Рыжий)	Molchat Doma	Этажи	spotify:track:3l823ZIO6hYZcOAruwQfoc
Коммерсанты	Molchat Doma	Этажи	spotify:track:3ZG5rYV6P7GYZgLIGczzkp
Клетка	Molchat Doma	Этажи	spotify:track:6WAfQig9RO3vdGfT03difJ
Naciste para Mi	Teodoro Reyes	15 Exitos	spotify:track:1uVq5XUmKBL3asiZtzGyRt

Contemporary Post Punk
Continental Shelf	Preoccupations	Viet Cong	spotify:track:3d5lGpqxg1cMEYrgTaGxZy
Silhouettes	Preoccupations	Viet Cong	spotify:track:07cUDeewEa1wMfKHUakxtK
Pontiac 87	Protomartyr	The Agent Intellect	spotify:track:3px7bE2OuvLHJHLxpZMgF6
Come & See	Protomartyr	Under Color of Official Right	spotify:track:0kY8guWctD1G5A3Cx66Ruj
It's All Coming Back	INVSN	INVSN	spotify:track:7Jbo2BG3fHQ47NtRqBDpJR
Ecstasy	Soviet Soviet	Fate	spotify:track:60sge80Y7m9wgd03OV4xWa
No Lesson	Soviet Soviet	Fate	spotify:track:2FfUxvwaNTtPYlyrESKtQH
Ruh	She Past Away	Klubb Död Compilation, Vol. 1	spotify:track:6UqXM2TcUdJJD8tuHzT4rU
The Dial	Squid	The Dial	spotify:track:55AP1tUevnOiiyffOQYeDB
Feral Cats	Protomartyr	No Passion All Technique	spotify:track:0fBbz92P4UUsPeSq7XfENe
Magic of Meghan	Dry Cleaning	Magic of Meghan	spotify:track:2aLK2WqtkW4pkBh8wH3lUn
Disarray	Preoccupations	New Material	spotify:track:2QlYpno65G6IJ2X3Yp4V9L
Concrete	shame	Songs of Praise	spotify:track:6X7H3JTAUGAL1rSwohnPBX

Irish Folk
Ríl Liatroma/The Green Cockade/The Mourne Mountains	Téada	Ceol & Cuimhne (Music & Memory)	spotify:track:1Vc39YjnHm0bHtMjiDu6kY
Dooley: Port an Deorai/ An Phis Fluich	Paul Dooley	Masters of the Irish Harp	spotify:track:7qteJ4f0SLqEX7TL087WSb
Brennans Reel	Martin Hayes Quartet	Brennans Reel	spotify:track:7DIJ8pWzjPPNNZi8BXbYjm
Last Nights Fun	Dervish	Playing With Fire	spotify:track:1vuy2weMPn1fCsqvpzzY1M
Molly Bán / Flowers of Edinburgh / Famous Ballymote	Ciaran Tourish	Down the Line	spotify:track:39YDPbenTXsY93zKizoqvn
The Gap of Dreams / Nia’s Jig / The Beekeeper	Altan	The Gap of Dreams	spotify:track:5MH17KACijBOpJZ6VGVibO
She Hasn't the Thing She Thought She Had / Denis Murphy's / Abbey's Green Isle	Danú	Ten Thousand Miles	spotify:track:4b1WBCojHWnAPbBbCUSJTE
Bodhran	Young Dubliners	Red	spotify:track:6LVEYsHd4qJ1WtJZ9xhr2X
The Mountain Road / Old Concertina Reel (2 Reels) [Live]	Frankie Gavin, Arty McGlynn, Aidan Coffey	Irlande (Live)	spotify:track:0Oh03sjYtG61Cju0IeO0dd
The Rocky Road to Dublin / The American Polka	We Banjo 3	Gather the Good	spotify:track:4akhlPKimkDKwOyJbKnugt
Goodbye Girls I'm Going to Boston	Laura Feddersen, Joel Wennerstrom, Owen Marshall	Wooden Nickels	spotify:track:4CH9ggXUaWwkvcGoQATrmO
The Lobster	The Gloaming	The Gloaming 3	spotify:track:5cHh5QK7QgXK669vYZOO7z
Jigs: The Southwest Wind / An Buachaillin Dreoite	The Fiddle Case	Write Me a Letter	spotify:track:17XDKfATaLDVs28Wh9Ry5J
Runs in the Family / Angry Birds	Adam Agee, Jon Sousa	Suantraí	spotify:track:71YL7LsmiRb8EErKnKWluE
The Killavil Jig / Billy O'rourke Is the Buachaill Jigs	P.J. Hayes, Martin Hayes	The Shores of Lough Graney	spotify:track:1nh3bUbH8smaGxFTJdCCmn
The Meelick Team / Whelan's Jig / Rolling Waves	Dermot Byrne, Kevin Crawford, Éilís Crean, John Doyle, Kenny Malone	The Lonesome Fiddler	spotify:track:2RbzVelNdSFosRBWc03Je7
The Musical Priest / The Blackthorn Stick	The Dubliners	The Dubliners	spotify:track:5UVEM0D973Vi52br39bkUR
Matt Peoples' (Reels)	Paul Brady, Tommy Peoples, Matt Molloy	Molloy, Brady, Peoples	spotify:track:2CI0ZIech2MEHtR2dsJcEF
Reels: Dinny O’Brien’s / The Sweetheart Reel / Paddy Kenny’s	Téada	In Spite of the Storm	spotify:track:5ALXCNEPR26rnNcdfKgn1z
Ríleanna / Reels: Ormond Sound, The Torn Jacket	Muireann Nic Amhlaoibh	Foxglove & Fuschia	spotify:track:1ubTZSN8vLJUk8Yjsjbz9y
Tamlin / Hand Me Down the Tackle / The Pure Drop	Seamus Egan	In Your Ear	spotify:track:3Xz4xhARyNb5YdvmmFmCym
Apples in Winter	Dervish	Decade	spotify:track:4twcqevRWiXRndhVhNpUvU
Eavesdropper	Ross Ainslie and Jarlath Henderson	Air-Fix	spotify:track:2swwhM8D6A9lp2ykYmNSQ1
Keepin’ It Reel	Boxing Banjo	Round #1	spotify:track:4saoSRB0NHOx75TIlVh5zM
Reels: Patsy Cambell's:Tie The Bonnet : Mick Finn's	Peter Carberry and Angelina Carberry and John Blake	Memories From The Holla	spotify:track:1y4rwW2PwLk6ukef9AxwIe
Humors of Tullycrine	Andrew Finn Magill	Drive & Lift	spotify:track:1ft8QzgCSuOfMOIP6FwMtK
Reels: Liz Carroll's, Paddy Ryan's Dream (feat. Eoin O'Neill)	Yvonne Casey	Yvonne Casey	spotify:track:5Rrjzr6ZuWfda10aATld8W
Gone to Fortingall/ Wired to the Moon	Jerry Douglas, Michael McGoldrick	Transatlantic Sessions - Series 6, Vol. Two	spotify:track:38xdrPnePc8lcnBw0HnLBi
Midsummer's Night	Dervish	Midsummer's Night	spotify:track:3C4majxDsONz0cwkkTnnkw
Fingal's Cave	Natalie MacMaster, Dave MacIsaac, Paddy Moloney, Martin Fay, Seán Keane, Matt Molloy, Derek Bell, Kevin Conneff	Fire In The Kitchen	spotify:track:4xFCMHRp0RdieQ1HkPaw4t
Belfast	Brian Finnegan	The Ravishing Genius of Bones	spotify:track:5P8LzctGucBj26sE78N7SP
Dolan's 6AM	Beoga	How to Tune a Fish	spotify:track:0VxzXknxAYjvcUL0GfAExj
Dot the Dragon's Eyes	Hanneke Cassel	Dot the Dragon's Eyes	spotify:track:5wdyCgTrwctSgjLhwdUWnK
Coolderry Bridge / The Whistling Postman / The Mills Are Grinding	The Fiddle Case	The Fiddle Case	spotify:track:5Id7Tp8vsvfLDFoUMVjyrn
Lady Montgomery: Lady Montgomery / Mutts Favourite / Up Da Stroods Da Sailor Goes	Session A9	Live at Celtic Connections	spotify:track:33XkqtATDmL4irlRL4UtCY
My Love Is In America	Martin Hayes & Dennis Cahill	The Lonesome Touch	spotify:track:6AIa3GdTUb2TsCj5SuGnS7
Echo	Talisk	Abyss	spotify:track:7ltSWDRkYI2DoFJiv77XUz
Tuttle's Reel	Lorkin O'Reilly	Heaven Depends	spotify:track:55T8dngArgGkHMA5a46jK6
Sligo Reel	Flook	Flatfish	spotify:track:1h6g7YxBOxPXFBSusn3wW4
Wee Michael's March / Frank's Reel - Live	mike mcgoldrick, John Doyle, John McCusker	The Mark Radcliffe Folk Sessions: McGoldrick McCusker Doyle	spotify:track:6l82Qy6UP49Z7NBh6UAMkf
The Fairy Reel / The Old Torn Petticoat / Our House at Home	Danú	Shanachie Presents Irish Celebration	spotify:track:1Dfh3b5KH6rs6bj5zOpK4M
Le Lys Vert	La Bottine Souriante, Yves Lambert, Robert Ellis, André Brunet, Jean Fréchette, Denis Frechette, Regent Archambault, Jocelyn Lapointe, André Verreault, Michel Bordeleau, Derek Bell, Matt Molloy, Kevin Conneff, Seán Keane, Martin Fay, Paddy Moloney	Fire In The Kitchen	spotify:track:43bVUpdwjc48HQtIBCdbo1
The Skylark	Culann's Hounds	Year Of The Dog	spotify:track:4zfIJDRXet5n7GEEFa81DM
The Dublin Lads, The Taproom, The Liffey Banks	Mick O'Brien & Caoimhín Ó Raghallaigh	Deadly Buzz | Aoibhinn Crónán	spotify:track:33d4Ee1QafVJga9Cu5MPvV
Cooley's/The Cup Of Tea/The Wise Maid (Reels)	Tulla Céilí Band	A Celebration of 50 Years	spotify:track:387gGrbI14zxr0tl5f31WQ
The Green Cottage / The Glin Cottage / Julia's Norwegian Polka	Brendan Begley & Caoimhín Ó Raghallaigh	A Moment of Madness	spotify:track:74QRLD0FXoaGpQ6YNNW6hj
Marcshlua Uí Néill (O'Neill's Cavalry March)	Seán Ó Riada	Ó Riada Sa Gaiety	spotify:track:0yuJx3DLCeiKwmblrXJPPX
The Expensive Sneeze	Ciorras	Silver Lining	spotify:track:1UgtNfZCpLe4j5GpnGcTNE
The Tinkers Stick, Sunny Banks, The Virginia	Catherine McEvoy, Caoimhín Ó Raghallaigh & Mícheál Ó Raghallaigh	Comb Your Hair and Curl It	spotify:track:4IgpOrxfmzRauwAtN6ZlL5
Kilfenora Reels: Connemara Stocking - The Westmeath Hunt - A Fair Wind	Kilfenora Fiddle Ceili Band	Irish Traditional Fiddle Music (Digitally Remastered)	spotify:track:0760mgHmuy6RoYgEYgEaki
Hardiman The Fiddler	Bob Brozman, John McSherry, Dónal O'Connor	Six Days In Down	spotify:track:0JJZfZebDAcmBT7Y1kcBtx
Gan ainm/The stormy night/Paddy Cronin's	Téada	Ceol & Cuimhne (Music & Memory)	spotify:track:0TV55v5AijvhZ3TdDvnJgR
The Walls of Liscarroll Jig	The Chieftains	The Chieftains 1	spotify:track:1tzAzy6DtJiS0gP7szseoA
Cooley's Jig	Noel Hill, Tony MacMahon	I gCnoc Na Graí	spotify:track:2VTQ8VMyIFCJ6nx3i2EdWY
An Buailteoir Aerach, The Enchanted Lady, The Holy Land	Mick O'Brien & Caoimhín Ó Raghallaigh	Deadly Buzz | Aoibhinn Crónán	spotify:track:7gaK8OBsNGcD1JcaN8FEcc
Girls Put the Fags Out: Ashplant - Red Haired Lass.	Oige	Live	spotify:track:41cWFTmNsCD9fYepvrK3rW
Roaring Mary / Stormy Weather	John Doherty	Bundle And Go	spotify:track:1ObSUAb8X6yH2rnJruvltj
Poirt: Delia Keane's/ the Horse's Leotard/ Seán Buí/ the Dawn Chorus	Téada	Inné Amárach	spotify:track:4xMIrCA6Lqs5kRlVBmC7eB
The Ships Are Sailing/The Cup Of Tea	Alan McCartney & Paul Bradley & Jason O'Rourke & Brendan O'Hare & Ray Gallen	Traditional Irish Music From Belfast	spotify:track:1AoBoAOHEE2n5iQ99ngKf6
Cronin's / I Do Not Incline	Jack Talty & Cormac Begley	Na Fir Bolg	spotify:track:3n1bWif204sqx4WEKNsC5o
Road Up the Bog / One More Pint / Karin Eating a Pickle	Marys Lane	Power in a Tiny Bottle	spotify:track:4YPAxoYh2yYyrRKrYYEeIR
The Fox Chase	The Fureys	The Spanish Cloak: The Best of the Fureys	spotify:track:397k1c9L1ywksIZ3jCJse3
The Strayaway Child / The Lark in the Morning	Michael Gorman, Margaret Barry	Classic Celtic Music from Smithsonian Folkways	spotify:track:7aaTYLPaja2A5dIkvJTSGh
The Lark in the Morning	James Kelly, Paddy O'Brien, Tommy Martin, Dáithí Sproule & Fintan Vallely	The Center for Irish Music - Young Irish Musicians Weekend Vol. 1	spotify:track:4OGO4r86zxmxBaQDDrEV7z
Accordion Solo - Slow Air/Reel: An Paistin Fionn (The Fair-Haired Boy) / The Flowers of Munster	Chulrua	Barefoot on the Altar	spotify:track:4cqW1rCeO5sfWZXGkvMMkq
Air: An Páistín Fionn	Willie Clancy	Willie Clancy The Gold Ring	spotify:track:03KG6RhbSVTuuUy8tModjE
The Green Hills of Tyrol / The Fermoy Lassies / The Pinch of Snuff [Reels]	Eileen Ivers, Semus Egan, John Doyle	Absolutely Irish	spotify:track:12bh7TbqCq2rhQrJUjuDar
Poll Halfpenny	Matt & Shannon Heaton	Lovers' Well	spotify:track:7cvqwSOqtiyVCaIEa6eM6P
Last Night's Fun / The Congress Reel	The Dubliners	The Dubliners	spotify:track:6luBtfDZxmuJanW9sLbG1u
Farewell to Connaught / Cooley Crossing the Shannon / The Ash Plant	Paul Bradley	Atlantic Roar	spotify:track:6oImqrLqhMgIkFk9h2inh0
The Black Rogue / Morrisons	Sean Maguire	A Man Apart	spotify:track:2W5OYrO4pf1jf0lFttbfUJ
The Concert Flute / Upstairs in a Tent	Finbar Dwyer	Kitty's Rambles	spotify:track:3BivsfcYy64qLcqkoKOJ0d
The Track for the Craic	Socks in the Frying Pan	Socks in the Frying Pan	spotify:track:2eT2QheRFkPxf4yElE0vQV
Caoineadh an Spailpín (The Spalpeen's Lament)	Willie Clancy	The Minstrel From Clare	spotify:track:7HGUltqTH6YqynkMQl3zzd
Lucy Campbell's / The Flogging (Reels)	Ciaran Tourish	Down the Line	spotify:track:6qjF0LNDQu7JN4A1LCgnlG
Coleraine Jig/Derrane's/John Stenson's/Mother Reel	De Danann All-Stars	The Star Spangled Molly	spotify:track:6KwgDPblRn3AjFBeaU3kbz
Dhá Pholca Dálaigh	Brendan Begley & Caoimhín Ó Raghallaigh	A Moment of Madness	spotify:track:6QC8MC3maNNp2uHsOMxxSP
Sean Bhean Bhocht Selection	MacDara Ó Raghallaigh	Ego Trip	spotify:track:4dKyou2FEq48lieMjUOnXN
The Hillsbrook Reels (Spike Island Lassies/Skyedance/Merry Harrier's Reel/Lady Gordon's)	Michael McGoldrick	Wired	spotify:track:5c8OuT4LQt9uVzRwMA5k6P
Branholm/Trip to Herve's	Flook	Flook! Live!	spotify:track:6GNpwVyyAdUb1FtTCL6ZjK
The Hag's Purse/Connaughtman's Rambles	Calath	Irish Celtic Music (Musica Celta Irlandesa)	spotify:track:09ZGID7lltzhNuVGa171RI
Shandon Bells/Boys Of The Town/Rakes Of Clonmel/Girls Of The Town	Brendan Mulvihill and Donna Long	The Morning Dew	spotify:track:5pqe0gd0C0k3Q636nWSrCs
Young Tom Ennis	Noel Hill, Tony MacMahon	I gCnoc Na Graí	spotify:track:1xFkHZexkiOKuldYGAX7eu
Glenside Céilí Band: Jackie Coleman's/The Hare's Paw	Glenside Céilí Band	Reunion Concert	spotify:track:3kW6XrBALTASTUrgGw0Yu0
Reels: Kylebrack Ramblers / Graf Spee	The Shaskeen Ceili Band	Pure Irish Céilí	spotify:track:6tWVMFlSwTPVOgeWBQMapG
Last Night's Fun / The Chattering Magpie / The Black Haired Lass / The Commodore	Billy McComiskey	The Girls Won't Leave The Boys Alone	spotify:track:3FnKOidmaJJzdP52XBWZ5f

Irish Indie Folk
My Love Took Me Down To The River To Silence Me	Little Green Cars	Absolute Zero (Deluxe Version)	spotify:track:6YhRNyYNmhiqPVgGx7hLp6
What We Called Love	Liza Flume	Full Steam Ahead	spotify:track:3e6i7hbLEnlPXh0KnrR6v8
Waiting for You	Isobel Anderson	In My Garden	spotify:track:09GKItLsZLhzxdz70rKhCt
Nothing Arrived	Villagers	{Awayland}	spotify:track:4Qegqm597Rw1PfaV43WkLy
Trusty and True	Damien Rice	My Favourite Faded Fantasy	spotify:track:3MtmLNzU2usLhwVHIE4cK2
Be the Song	Foy Vance	Be the Song	spotify:track:5uFnBjrDzvYz48xvUwBRBd
Brother	Kodaline	Brother	spotify:track:6dVa7xk5dOoT6pOkDw1TMH
Let's Be Young	Picture This	Picture This EP	spotify:track:2MhvsKomZzArVoLCcwg2D2
Speeding Cars	Walking On Cars	Everything This Way	spotify:track:4GylZDT7adqIfVoPHyFb5X
Chasing Rubies	Hudson Taylor	Singing For Strangers	spotify:track:7jcWMiBpsutzCWbGFZHkDI
Oceans	Seafret	Tell Me It's Real (Expanded Edition)	spotify:track:5eXnC2B5RU5fAhfwvV2ABD
Down	Andrew Belle	Down	spotify:track:7FJvnbvMoz16kPzKWLfU75
Oh Brother	Saint Raymond	Oh Brother	spotify:track:4VBZbQw57uAtXTtwPBMYm2
She Wants	Sunset Sons	She Wants	spotify:track:5WW122rIxfwIOfUnhNi7PM
Friends	Eliza and the Bear	Eliza And The Bear	spotify:track:3m71DIViQRCBaPG41WQXES
Unsteady	X Ambassadors	VHS	spotify:track:6cSsWi1c3ewIEmbqdUWsUM
Another Love	Tom Odell	Long Way Down (Deluxe)	spotify:track:3JvKfv6T31zO0ini8iNItO
Run	Chasing Grace	Nowhere Near Old Enough	spotify:track:2ImfiS8qdWSfx8Ec6iMYHY
little light - acoustic version	Lewis Watson	little light (acoustic version)	spotify:track:6PRotAx0lUWP0bHBr6jm42
I'll Be Good	Jaymes Young	Feel Something	spotify:track:4JuJZzGcswQszYiKJSnC6i
Work Song	Hozier	Hozier	spotify:track:3UfCFlGruX0DRPCpD1V3pU
Changing Tides	The Fray	Through the Years: The Best of The Fray	spotify:track:6RVz4ORFnJI2Ye4DgWUUVF
Please Notice	Christian Leave	Hope	spotify:track:36seMHoyXmLUNxcwzwjdF7
Spirit Cold	Tall Heights	Neptune	spotify:track:1vG6jMgSoqT3zG9tuDrL2E
Hunger	Ross Copperman	Hunger	spotify:track:7k9GuJYLp2AzqokyEdwEw2
Half Light	BANNERS	Half Light	spotify:track:1iZn69GnmLDNkvWiw6W4Jd
Brother - Acoustic	Kodaline	Brother (Acoustic)	spotify:track:5udBIsHBmGtQqKnYup1hsx
Cloud	Elias	Warcry	spotify:track:6zbloekTCMEa2U1YYvIKB9
The Wreck	Delta Spirit	Into the Wide	spotify:track:7AxzTgSvzRiGqUTxlZVilc
Olivia (Bonus Track)	Canyon City	Midnight Waves	spotify:track:4WXIT2SsODNntoxR8EIw6d
Home II	Dotan	7 Layers	spotify:track:5EbqMIr0c8BJMmXl4SX2P9
Confession	D'Artagnan	A-Side	spotify:track:5oHpZBDnuCA5WA6G8tZs9V
The One	Kodaline	Coming Up for Air (Expanded Edition)	spotify:track:0My8NPmENHrN5W7OfgZnZJ
Guiding Light	Foy Vance, Ed Sheeran	Joy Of Nothing	spotify:track:3CJakOJKCXKbTgqf2anMd1
Dearly Departed (feat. Esmé Patterson)	Shakey Graves	And The War Came	spotify:track:0ewrI06EIDMGXvgJxuyF3U
Daydreamin	Jonathan Tilkin	Daydreamin	spotify:track:4SMEVj9Ods3ukQg41vWCUy
Knocking on Heavens Door	RAIGN	Knocking On Heavens Door - EP	spotify:track:20jZ7lf5eqDUQQruuMSKVE
Wildfire	Seafret	Tell Me It's Real (Expanded Edition)	spotify:track:2Ro9FLIVhPwIQopSr48oJT
Anchor	Novo Amor	Bathing Beach	spotify:track:7qH9Z4dJEN0l9bidizW7fq
Carry You	Novo Amor	Bathing Beach	spotify:track:0u4rkpmNtgcFxYHepnVF4v
Alps	Novo Amor, Ed Tullett	Alps	spotify:track:5eG8QuQKOBvDeCyoOeMkhT
Don't You Dare	Winnie Raeder	Don't You Dare	spotify:track:4NCjNWpT35pN9LAWKn8sUQ
Vagabond	Caamp	Caamp	spotify:track:3HAgxyWGeJtIVabS2mTREt
Rosyln	Bon Iver, St. Vincent	The Twilight Saga: New Moon (Original Motion Picture Soundtrack) [Deluxe]	spotify:track:56ToH3YiSMT51y1H2dygOX

Irish Folk Recommendations
When First I Went to Sea	Katie Else	Songs from Across the Lake and Sea	spotify:track:6Dni716awL7NjSf3Sdc6ha
The Rocks of Bawn	Katie Else	Songs from Across the Lake and Sea	spotify:track:5zAeQD4D37XIAVOoCKmAmd
Gaol Ise Gaol I	Katie Else	Songs from Across the Lake and Sea	spotify:track:0u1gmI26sxJGknMCYwrq2t
Amhrán Mhuínse	Katie Else	Songs from Across the Lake and Sea	spotify:track:2uKQ20Y4r6UUwq0mPmmrMz
Barr an tSléibhe	Katie Else	Songs from Across the Lake and Sea	spotify:track:5HS28f8Q5EyWEJdBMuCJmo
Leaving Arranmore	Katie Else	Songs from Across the Lake and Sea	spotify:track:1oWcJ1xV1qRPenyvkmtgMh
1913 Massacre	Katie Else	Songs from Across the Lake and Sea	spotify:track:0oJxS7Ayh50j2jz8b3XkvW
Nuair a Ràinig Mi'm Baile	Katie Else	Songs from Across the Lake and Sea	spotify:track:5gr5SvkowCvYq0kIj7wlCT
Sail Óg Rua	Katie Else	Songs from Across the Lake and Sea	spotify:track:1DKBv3up2B6clW4b5ddEiI
Casadh an Tsúgáin / Frankie's Song	Iarla Ó Lionáird	Brooklyn (Original Motion Picture Soundtrack)	spotify:track:1lIcz0D2LAMHwgTycERNnu
Fainne Geal an Lae	Iarla Ó Lionáird	Foxlight	spotify:track:6YDfvgHYcrfI85a4jX09gz
Coaineadh Na Dtrí Muire (Lament of the Three Marys)	Iarla Ó Lionáird	The Highland Sessions: Volume Two	spotify:track:7LGIoetYutjWELOobKrlj9
Mo Ghile Mear (My Dashing Darling)	Iarla Ó Lionáird, Mary Black, Karen Matheson, Karan Casey, Mary Ann Kennedy, Allan MacDonald	The Highland Sessions: Volume Three	spotify:track:5PakwvIWrcVNOhESLUdn0e
Taimse im' chodhladh (I Am Asleep)	Iarla Ó Lionáird	The Highland Sessions: Volume One	spotify:track:0ue1Ez8jWyYs2kxr7vyxTc
The Goat Song	Iarla Ó Lionáird	Foxlight	spotify:track:2lOPwvyL4wRSVvNDfxHPBD
Taimse Im' Chodladh	Iarla Ó Lionáird	Invisible Fields	spotify:track:0n3MAKuK7PIjC4dy0nxLBc
Caoineadh Na dTrí Mhuire	Iarla Ó Lionáird	The Seven Steps to Mercy	spotify:track:5rBe0ePNSwgT2P0MxE3BHM
Seacht	Iarla Ó Lionáird	The Seven Steps to Mercy	spotify:track:4B0jesrNZTknKsT2p4Z39o
The Foggy Dew - Live	Colm Mac Con Iomaire, Iarla Ó Lionáird	Other Voices 15 (Live)	spotify:track:1xcL2xv1C92mqCJVLojMXJ
The Rocky Road to Dublin - Live	The Dubliners	The Dubliners (Bonus Track Edition)	spotify:track:6Mer1LOfJDd7vUbeWXODrq
Whiskey in the Jar	The Dubliners	The Best Of The Dubliners	spotify:track:1UzofFX5AkfTDnwjcBkM4J
Black Velvet Band	The Dubliners	The Essential Collection	spotify:track:3eLJLZn6bkE6il9x5pS07g
Seven Drunken Nights	The Dubliners	Dublin	spotify:track:0mBgPugbdJQCIAy0YMxG26
The Town I Loved So Well	The Dubliners	The Dubliners	spotify:track:0Db6ciT3uXIpkn5gdfSJUB
The Wild Rover (Live)	The Dubliners	Legendary Concert of the Dubliners 40 Years Reunion (Live)	spotify:track:5eCuReHDkL7n9AOkm3jlox
The Fields of Athenry (Live)	The Dubliners	Legendary Concert of the Dubliners 40 Years Reunion (Live)	spotify:track:2TSECkog1zEEEg5Z9XNqLE
Whiskey in the Jar	The Pogues, The Dubliners	Hell's Ditch (Expanded Edition)	spotify:track:1rJCuds0vDMAjF5RdZU7bq
The Musical Priest / The Blackthorn Stick	The Dubliners	The Dubliners	spotify:track:5UVEM0D973Vi52br39bkUR
Oro Se Do Bheatha 'Bhaile	The Dubliners	25 Years Celebration	spotify:track:4Cht4IwOKR23JU1YrIxCcS

cold
Nightshift	THE NAMES	Swimming	spotify:track:46e2w9UX6mftXJDwhJKKAO
Discovery	THE NAMES	Swimming	spotify:track:0pxPjXY25KFJZq5WNv9YPu
Calcutta	THE NAMES	Swimming	spotify:track:3dZMvsCWhmcWnAEZ8Dr6vp
Life By the Sea	THE NAMES	Swimming	spotify:track:2D8ov6fqvb6cjtLw95PPM8
Spectators Of Life	THE NAMES	Spectators Of Life	spotify:track:45pRasLCDepR7PDuCD7WK2
Seven Years	Eyeless In Gaza	Photographs As Memories	spotify:track:6d81COn50kdz2P1UpdsMFV
New Risen	Eyeless In Gaza	Back From The Rains	spotify:track:2FEAy5yBfjOxENb752I0UY
Veil Like Calm	Eyeless In Gaza	Voice - The Best Of Eyeless In Gaza	spotify:track:7qEB4CBNL4QtYIDcORhbwr
Evening Music	Eyeless In Gaza	Back From The Rains	spotify:track:7eP7cbnyeRaAy6vWy5hG8P
My Last, Lost Melody	Eyeless In Gaza	Back From The Rains	spotify:track:6GDiBhZ37dENDmgCrcuKqD
Tenth Planet	Solid Space	Space Museum	spotify:track:774lbtnXHtm3SzHlYp2mTO
A Darkness in My Soul	Solid Space	Space Museum	spotify:track:4baFyZSUVlqMGsiptP4rwe
Spectrum is Green	Solid Space	Space Museum	spotify:track:6ppyLbtxq531ZUn3ot5YOK
Somewhere	The Danse Society	Seduction (The Society Collection)	spotify:track:6AqzHdj8Wlokm62tmFwG1D
We're So Happy	The Danse Society	Seduction (The Society Collection)	spotify:track:3gjLdLHagRcSIbkQYI4zAe
Hide	The Danse Society	Seduction (The Society Collection)	spotify:track:2Yc6u4sFVc3b7tKak7knmN
Clock	The Danse Society	Seduction (The Society Collection)	spotify:track:4iQUmNFs5H3pu8P11r2Kci
Heaven Is Waiting	The Danse Society	Heaven Is Waiting	spotify:track:6l6LfotaUCEftiRJW4Yeij
Grey Skies	Turquoise Days	Alternative Strategies	spotify:track:2wlEhVv8g8fqZzD6jZxCMW
Blurred	Turquoise Days	Alternative Strategies	spotify:track:78u3IN8igxP3LsTPZtA7SI
Scattering Seeds	Turquoise Days	Alternative Strategies	spotify:track:23tJ5V6bNTslFIjYGNPiXV
Alternative Strategies	Turquoise Days	Alternative Strategies	spotify:track:4nd4ENA176CYynxlNtZNld
Hide	Turquoise Days	Alternative Strategies	spotify:track:4MmVpyCBKxjsuBTrM1JYnu
Another Land	Medio Mutante	Eadem Mutata Resurgo	spotify:track:0xuBaltXI98NLF6wlWVhMT
Corre Corre	Medio Mutante	Eadem Mutata Resurgo	spotify:track:65avJZHTYSJHtwXH23HCcC
Tu Y Yo	Medio Mutante	Eadem Mutata Resurgo	spotify:track:7rwTIuGpfS5GwAQvdg7lhM
17 Años	Medio Mutante	Eadem Mutata Resurgo	spotify:track:3EsUyi4AhpJrnHNtDAZbmI
Inestable	Medio Mutante	Eadem Mutata Resurgo	spotify:track:47ybdU02Gqg9A7nKN8yrtn
Inside Out	Martin Dupont	Hot Paradox	spotify:track:1tbL1iLdlz8fLqopGAL6zZ
Just Because	Martin Dupont	Lost and Late...	spotify:track:4VSvIv9JIDAukgLtS1U6Az
Your Passion	Martin Dupont	Lost and Late...	spotify:track:6lgBWPO5csBm2N24LGMXdl
He Saw the Light	Martin Dupont	Hot Paradox	spotify:track:065Nako4tuel6NDQpKkcWq
Pain	Boy Harsher	Lesser Man EP	spotify:track:13HYthybjhM3iyWcfl8VcN

Laiko
Ta Paidia Ton Fanarion	Nikos Kourkoulis	The Digital Collection	spotify:track:5UyUIN1Vml7AbJYj5oBumP
Ke Me Pernoun Ta Klamata	Stamatis Gonidis	The Digital Collection	spotify:track:1redBI9rwiZBfjQsQ3ZoHY
Den Thelo Tetious Filous	Natasa Theodoridou, Pashalis Terzis	Dipla Se Sena	spotify:track:6LmT09OnqCHvrWDCBMSVas
Bros Gremos Ke Piso Esi	Pashalis Terzis	Glenti Me Ton Pashali	spotify:track:6HWBIbunW7vTVizmprDdLn
Aliti M' Eipes Mia Vradia	Sotiria Bellou	Rebetika (Best of the Best)	spotify:track:633OmnOCYa6H1ZwrdtLmQS
Fotia Sta Savatovrada	Angela Dimitriou	A Night In Greece	spotify:track:2IxIJbbUcso6gVVHsou928
Ah Koritsi Mou	Giannis Ploutarhos	Mikres Fotografies	spotify:track:6RM4uRehk0XvKUzYO3Y93L

A lot of coldwave
Back to Cruelty	Marquis De Sade	Rue de Siam	spotify:track:4TdbRy6U37uvGvUp3SHj7N
Wanda's Loving Boy	Marquis De Sade	Rue de Siam	spotify:track:3GvHIVhpc4Qg5M79dzRIF4
S.a.i.d.	Marquis De Sade	Rue de Siam	spotify:track:6rPe0a28ob6nUwszI4rW3K
Stairs and Halls	Marquis De Sade	Rue de Siam	spotify:track:4Jvyet7PP2qIiOTyi1cc0B
Silent World	Marquis De Sade	Rue de Siam	spotify:track:69msGHeqSaEfLAkc11jQeQ
Cancer and Drugs	Marquis De Sade	Rue de Siam	spotify:track:3a5nJsSl4YGnuW6YY4cg13
Iwo Jima Song	Marquis De Sade	Rue de Siam	spotify:track:6NyyiS05LOlpkRmEQw8uHL
Final Fog (brouillard définitif)	Marquis De Sade	Rue de Siam	spotify:track:7byBtl3LIfIC5HMhnrSm7s
Rue de Siam / Submarines and Iceberg	Marquis De Sade	Rue de Siam	spotify:track:2DUXSeX1dUvaBkY46cemIO
Rythmiques	Marquis De Sade	Rue de Siam	spotify:track:7h5lXLUwH9xniv7100leQf
White Light-White Heat	Marquis De Sade	Rue de Siam	spotify:track:37RnL2VtAwlAHIcj6OeUON
Exposition	Charles De Goal	Etat général	spotify:track:5pvYdwSvfSMINT6k2abCEl
Technicolor	Charles De Goal	Etat général	spotify:track:6RlDhHYYSZqroajufTtrmE
Dans le labyrinthe	Charles De Goal	Etat général	spotify:track:2Mei7rn8qyDUjoCHbFnkTZ
Modem	Charles De Goal	Etat général	spotify:track:4tfjiOg1qFPcQQZWV6ypUQ
Décadence	Charles De Goal	Restructuration	spotify:track:1NFC0TAHuOOfnFHmEeOdR7
Mind	Kas Product	Black & Noir - Mutant Synth-Punk from France 1980-83	spotify:track:3VqYELrjEBAUcgqxt4fmzf
Seven	Kas Product	Black & Noir - Mutant Synth-Punk from France 1980-83	spotify:track:0jrXnRx5W3pbZ6d0cOOCfO
Take Me Tonight	Kas Product	Black & Noir - Mutant Synth-Punk from France 1980-83	spotify:track:5j1PZQP65WV2jdc4jIbpDp
Crash	Kas Product	Black & Noir - Mutant Synth-Punk from France 1980-83	spotify:track:5T52jfBLtjQ5jpqXaLPAQv
Black & Noir	Kas Product	Black & Noir - Mutant Synth-Punk from France 1980-83	spotify:track:3aKZPcBoo52ED7K93wKGKD
Just Because	Martin Dupont	Lost and Late...	spotify:track:4VSvIv9JIDAukgLtS1U6Az
Inside Out	Martin Dupont	Hot Paradox	spotify:track:1tbL1iLdlz8fLqopGAL6zZ
Your Passion	Martin Dupont	Lost and Late...	spotify:track:6lgBWPO5csBm2N24LGMXdl
Just Because - 1985 Remix	Martin Dupont	Lost and Late...	spotify:track:14BWeALGUsi6YJ17m4BfWQ
The Light Goes Through My Mouth	Martin Dupont	Selectors 003 - Marcel Dettmann	spotify:track:4pXw06oomuzHuARW9JNHbS
Sheen	Xeno & Oaklander	Par Avion	spotify:track:12x8gQl2UYcQ3tizSfoPbZ
Sets & Lights	Xeno & Oaklander	Sets & Lights	spotify:track:2rpzKZTEQbXYi5lLNsyQlT
Angélique	Xeno & Oaklander	Hypnos	spotify:track:3wuCJ5kPmKvrvIbreDVrm1
Fire and Smoke	Xeno & Oaklander	Hypnos	spotify:track:1JlY83QvYEvCSws9Z8DXfK
Hypnos	Xeno & Oaklander	Hypnos	spotify:track:1g2EhmNU2gZgMUJLJbo1jd
Insomnia	Xeno & Oaklander	Hypnos	spotify:track:26NDczI3hV4SpSonH34ud7
Marble	Xeno & Oaklander	Topiary	spotify:track:26nCJikb3DDUB3OoWIf38x
Chevron	Xeno & Oaklander	Topiary	spotify:track:4m9SOhNT5KbrHcFRNQTPtu
Altamira	Xeno & Oaklander	Hypnos	spotify:track:4jl0qbUOkIXUNs1wQCYpaM
The Light, The Whisper	Xeno & Oaklander	Hypnos	spotify:track:3stGdvqidESxs3yxx0FcoK

Russian Doll Things
Synapse	Linea Aspera	Linea Aspera	spotify:track:4X3IQUzwAE8ZR5N1lTQl9x
I Hope You Die	Molly Nilsson	History	spotify:track:5kWbmJzK2LYNLhcs7DKR9e
Black Light	Replicant	Black Light	spotify:track:0tRbPkxR4XF4xtVbMV2yRF
Skin	Zola Jesus	Conatus	spotify:track:2OBnIbLErfbt47kSPmCfAw
M.P.S.	Institute	Readjusting the Locks	spotify:track:25Sht3Cw5gbrhAO10xyHtb
Deception	The Crüxshadows	Frozen Embers	spotify:track:0bpvLZBlLfNjLnFtoCKIxV
Pale Empress	The Merry Thoughts	New Alternatives II	spotify:track:0MpED5lINAluPXp1zoS0Zq
Tenement Roofs	Glorious Din	Killed By Deathrock Vol.1	spotify:track:0k4Wrb5rgyorZhkVBM5PKA
Low Violet	The Merry Thoughts	Angel Child III - Belief in Angels	spotify:track:4zuJ1LXpRO7z3cRwDD17n7
A Mirage	The Essence	Monument Of Trust	spotify:track:3QCDdkUAk1h4mYq0JZybTb
Ruh	She Past Away	Klubb Död Compilation, Vol. 1	spotify:track:6UqXM2TcUdJJD8tuHzT4rU
Asimilasyon	She Past Away	Narin Yalnizlik	spotify:track:513Btbko3502Gth1g7Seyj
Ritüel	She Past Away	Belirdi Gece	spotify:track:53STwUcy9VxTLyAVLLGQyy
Funeral Train	Merciful Nuns	Lib. 1	spotify:track:6eXv1NUnjAhwFVy5WGNwov
Love Still Remains	Angels of Liberty, N/A	Telepathine	spotify:track:4RYblqrlDN35sieIrDLZAK
Nineties - Remastered	Star Industry	Last Crusades Limited CD	spotify:track:1NC98F1BQgf7KIJ8BByMtR
Twist in My Sobriety	Dreadful Shadows	The Cycle	spotify:track:1LSPp0Kf6ga3re5Cw55HAz
Shallow Tears	Light Asylum	Light Asylum	spotify:track:3NBL0bmfyNXGY5dmHYtXqS
End Of Days	Light Asylum	Light Asylum	spotify:track:3JkXtYFKKBMZoOfqoKBxPP
Skull Fuct	Light Asylum	In Tension	spotify:track:733DmeMDHqot4Oa2QIft6r
A Mirage	The Essence	Monument Of Trust	spotify:track:3QCDdkUAk1h4mYq0JZybTb
The Cat	The Essence	Purity	spotify:track:3F9PyYx4534XEULXyfMR16
Only For You	The Essence	Ecstasy / Nothing Lasts Forever	spotify:track:5kiBYHz1VC5a0pmxLRVFm9
Endless Lakes	The Essence	Purity	spotify:track:0b7lPwXd0YkfJ49jJhI8qS

Arts & Crafts
Churches Under The Stairs	Brendan Canning	Something For All Of Us	spotify:track:4ClpttuOtUPo9Mzzm9xF6X
Hit The Wall	Brendan Canning	Something For All Of Us	spotify:track:0uIhXRlf0CbM3jq3J9tMtP
Leave With Me	Memphis	Leave With Me	spotify:track:2fxPtRI2sxkgAgipFd2PhL
What Is This Thing Called?	Memphis	Here Comes A City	spotify:track:6ldbxfuflDAaAvbb3f3an4
I Am The Photographer	Memphis	Here Comes A City	spotify:track:2NrDPKobJx1uZ5nGLAUXqH
Into The Wild	Memphis	I Dreamed We Fell Apart	spotify:track:6VKMHeJs1FFggF5yFSEGiA
Cause = Time	Broken Social Scene	You Forgot It In People	spotify:track:17z65LFVRqSVJCMyjfrBm9
7/4 (Shoreline)	Broken Social Scene	Broken Social Scene	spotify:track:5PurHGjwfAQel15O4ZIiGu
Stars and Sons	Broken Social Scene	You Forgot It In People	spotify:track:34NxpUqK4BZmVB9Pe6VuUZ
Hug Of Thunder	Broken Social Scene	Hug Of Thunder	spotify:track:5eyTSlaihupr5Evo1pigNw
Soft Revolution	Stars	Set Yourself On Fire	spotify:track:1Jyxd07rjWsZND6ONooOi3
Mushaboom	Feist	Let It Die	spotify:track:66olzBxCgKlpFRB1LKH5pO
Lola Stars and Stripes	The Stills	Logic Will Break Your Heart (U.S. Version)	spotify:track:7yWNhXwWG4dYThGatvhCDq
Disclaimer	The Dears	Missiles	spotify:track:45IXk8okNY8JtBsiYiu74e
Ready to Shine	Young Galaxy	Falsework	spotify:track:2KbO34e8OSEOcTRStMOPdV
Safety Bricks	Kevin Drew	Spirit If...	spotify:track:6E5eLNRpkb9JSPUc6OLJg1
Grow Up and Blow Away	Metric	Grow Up And Blow Away	spotify:track:4tTSPlJX18X8qksCzmvVPj
National Anthem Of Nowhere	Apostle Of Hustle	National Anthem Of Nowhere	spotify:track:4fdz58gX16zO8BLTU0LWXJ
Hangover Days	Jason Collett	Idols Of Exile	spotify:track:1Tmgfl1TWPV9Lb4jHMssjg
A Lesson In Crime	Tokyo Police Club	Smith	spotify:track:7vTjAqWDyYr7T8yy4e07bd
Book It To Fresno	Brendan Canning	Home Wrecking Years	spotify:track:2yW6UbYHHvdgYnEvIFV1KL
Mexican After Show Party	Kevin Drew	Darlings	spotify:track:1SDC5uRZVmgDNxMhfOrBrr
You In Your Were	Kevin Drew	Darlings	spotify:track:375k5vfp7Hyd8VCc5O9Qt0

Arts and Crafts Audit
Cause = Time	Broken Social Scene	You Forgot It In People	spotify:track:17z65LFVRqSVJCMyjfrBm9
Soft Revolution	Stars	Set Yourself On Fire	spotify:track:1Jyxd07rjWsZND6ONooOi3
Mushaboom	Feist	Let It Die	spotify:track:66olzBxCgKlpFRB1LKH5pO
Lola Stars and Stripes	The Stills	Logic Will Break Your Heart (U.S. Version)	spotify:track:7yWNhXwWG4dYThGatvhCDq
Disclaimer	The Dears	Missiles	spotify:track:45IXk8okNY8JtBsiYiu74e
Ready to Shine	Young Galaxy	Falsework	spotify:track:2KbO34e8OSEOcTRStMOPdV
7/4 (Shoreline)	Broken Social Scene	Broken Social Scene	spotify:track:5PurHGjwfAQel15O4ZIiGu
Safety Bricks	Kevin Drew	Spirit If...	spotify:track:6E5eLNRpkb9JSPUc6OLJg1
Churches Under The Stairs	Brendan Canning	Something For All Of Us	spotify:track:4ClpttuOtUPo9Mzzm9xF6X
Grow Up and Blow Away	Metric	Grow Up And Blow Away	spotify:track:4tTSPlJX18X8qksCzmvVPj
Games For Days	Julian Plenti	Julian Plenti Is… Skyscraper	spotify:track:5tTiveFWvwhOpwyTMtmqve
Can You Tell	Ra Ra Riot	The Rhumb Line	spotify:track:1CJz0q1JhAnSJCF2DnqTrG
National Anthem Of Nowhere	Apostle Of Hustle	National Anthem Of Nowhere	spotify:track:4fdz58gX16zO8BLTU0LWXJ
I Want The Lights On After Dark	Memphis	Here Comes A City	spotify:track:4Qhzy3aQ3WvuezfwdMGT10
You Never Really Knew Me	Memphis	Leave With Me	spotify:track:0YXQ1X9aT0I4qdP5H4HzWT
Leave With Me	Memphis	Leave With Me	spotify:track:2fxPtRI2sxkgAgipFd2PhL
Basil	Memphis	Leave With Me	spotify:track:3NnZVrLAOfwrq8lLqY3lbC
Since I Didn't Die	Memphis	Leave With Me	spotify:track:3lJWeky2tS14h1M5aivBDp
Camilo - The Magician	Said The Whale	Islands Disappear	spotify:track:2JJ9gp9kG8vhW5V97LDvRL
UnAmerican	Said The Whale	Cascadia	spotify:track:0qSTijeNE9JwdrU1HUmWhY
Record Shop	Said The Whale	Cascadia	spotify:track:44jvccYToFFYHqP7IiGIRT
I Love You	Said The Whale	hawaiii	spotify:track:45g3mVFQOWb2isoj2Swwil
Level Best	Said The Whale	Cascadia	spotify:track:1vjHTiQG1HO1ly4PJB2vaU
My Sword Hand's Anger	Apostle Of Hustle	National Anthem Of Nowhere	spotify:track:4dXPBrBelrfdnMY5giDpFV
Folkloric Feel	Apostle Of Hustle	Folkloric Feel	spotify:track:1COdhaDfNXYmXbfHPJzP0v
Cheap Like Sebastien	Apostle Of Hustle	National Anthem Of Nowhere	spotify:track:7uxibofRBJoEGJx46mjXkv
Sleepwalking Ballad	Apostle Of Hustle	Folkloric Feel	spotify:track:3esJ3Xt21qvG0VAFs6YVJR
Energy Of Death	Apostle Of Hustle	Folkloric Feel	spotify:track:13PhxzvGQVMZRLbRbaEoH4
Good Sex	Kevin Drew	Darlings	spotify:track:6KdDL0uNMAFdgzjCm1PQZ6
Love vs. Porn	Kevin Drew	Dark Was The Night (Red Hot Compilation)	spotify:track:3jcoAtNTBhOR6956zNIf3E
You In Your Were	Kevin Drew	Darlings	spotify:track:375k5vfp7Hyd8VCc5O9Qt0
Tbtf	Kevin Drew	Spirit If...	spotify:track:7Dha5Jw4EVQbFHe58pJ5AU
F-ked Up Kid	Kevin Drew	Spirit If...	spotify:track:5OFuNX7P5H1O2fbhM2kDYH
Churches Under The Stairs	Brendan Canning	Something For All Of Us	spotify:track:4ClpttuOtUPo9Mzzm9xF6X
Chameleon	Brendan Canning	Something For All Of Us	spotify:track:5FEOPd2uvBSp8qP7vajwPI
Book It To Fresno	Brendan Canning	Home Wrecking Years	spotify:track:2yW6UbYHHvdgYnEvIFV1KL
Hit The Wall	Brendan Canning	Something For All Of Us	spotify:track:0uIhXRlf0CbM3jq3J9tMtP
Keystone Dealers	Brendan Canning	Home Wrecking Years	spotify:track:5ITnnZlzCI8XZAFv5SQhb9
Ontario Morning	The Most Serene Republic	Mediac	spotify:track:1gNzS4g3chVrtxv2xnGpen
Humble Peasants	The Most Serene Republic	Population	spotify:track:7exQs7m6CnQixB28NSLmxw
Love Loves to Love Love	The Most Serene Republic	Mediac	spotify:track:2RhqkxE0G5U1ZPYrrpMvX1
Present Of Future End	The Most Serene Republic	Population	spotify:track:2QSE5UTiWAbzHAQCtxMnf4
Heavens To Purgatory	The Most Serene Republic	...And The Ever Expanding Universe	spotify:track:6RsmVKZ2yWJ891cxZZrCcu
Hangover Days	Jason Collett	Idols Of Exile	spotify:track:1Tmgfl1TWPV9Lb4jHMssjg
Song And Dance Man	Jason Collett	Song And Dance Man	spotify:track:3KwdtIdHyQHWCUA4BxDGiY
Love You Babe	Jason Collett	Song And Dance Man	spotify:track:1MOsX348789QZbhgS7Y3U7
Provincial Blues	Jason Collett	Song And Dance Man	spotify:track:3W6RlOmQz9vhRCNy56incf
These Are The Days	Jason Collett	Idols Of Exile	spotify:track:44g0kd30idU74ePM1sV9HO
I Will Follow You Into the Dark	Amy Millan	Masters Of The Burial	spotify:track:6vlGGHwi7RNolZCXdgPICC
Skinny Boy	Amy Millan	Honey From The Tombs	spotify:track:12DTMnp9HVukRbRAt9d0Z1
Lost Compass	Amy Millan	Masters Of The Burial	spotify:track:1Zi3wEa69CYPUt1fG44NnC
Losin' You	Amy Millan	Honey From The Tombs	spotify:track:15DVuosk2ceIHICTjQBcPL
Baby I	Amy Millan	Honey From The Tombs	spotify:track:07AEpZnx10LG5ZZlrKLMEN
What Else Is There ?	Röyksopp	The Understanding	spotify:track:238vPTkV2cKupWDnAietb6
Church (Lost Tapes)	Röyksopp	Church (Lost Tapes)	spotify:track:5FQp1qtfMzMNuvYsNz2NGz
Rising Urge (Lost Tapes) - Original	Röyksopp	Rising Urge (Lost Tapes) [Original]	spotify:track:4D2zAaCFuDMlIboD7UH8X5
Eple	Röyksopp	Melody AM	spotify:track:0Zw4llKeB35SIKASy1aLtV
In the End (Lost Tapes)	Röyksopp, Man Without Country, Susanne Sundfør	In the End (Lost Tapes)	spotify:track:2vyACbL11HoiWTcA6Ri7wU
Kim & Jessie - Montag Remix	M83, Montag	Saturdays=Youth Remixes & B-Sides	spotify:track:5hoAXHQpWuwEYNGu8Ol5ad
The Black House, the Blue Sky - Stars vs. Montag	Stars, Montag	The Five Ghosts	spotify:track:4sXvTAykaB0RSw7fWvsNHL
True Love (feat. Native Cell)	Montag, Native Cell	Phases	spotify:track:0lQQXsqxZS6Z6tlZ80dHuv
I Have Sound	Montag	Going Places	spotify:track:0wvwM2WoNVRZ3YB5CfWO3V
Sommernacht	Montag	Montag	spotify:track:1VDIcpWhSBe8b8UbZWJaDR
Tulips - Minotaur Shock Remix	Minotaur Shock, Bloc Party	Evil Nine Present : Y4K	spotify:track:0SwecF3sQwuTEqWnsPYVk0
Prittskin	Minotaur Shock	MINO	spotify:track:3mBpxRHdQZsRJ3U5kd0Jn5
Petr Petr	Minotaur Shock	MINO	spotify:track:7xQixhZ7hwjkgIIWNGs7Ih
The Broads	Minotaur Shock	Maritime	spotify:track:0IrmXOpVwz03SINAC1UukQ
Flytip Toe	Minotaur Shock	MINO	spotify:track:2boQwapglHNMJQOzrEMapR
Over It	Junior Boys	Big Black Coat	spotify:track:7yLS3sYpFKIUsVFXxu8uuK
In The Morning	Junior Boys	So This Is Goodbye	spotify:track:3FUq5TseOjqUU4RXbO2y66
Parallel Lines	Junior Boys	Begone Dull Care	spotify:track:2Z8pdn7iDjaCwND5R3KQuX
Dull to Pause	Junior Boys	Begone Dull Care	spotify:track:13iGkvUtzm79OtStnf995p
Teach Me How To Fight	Junior Boys	Last Exit	spotify:track:1cRYMskqTgzyZdwNO8fSDS
Paul Simon	The Russian Futurists	Our Thickness	spotify:track:7nehIFDXsZE0KYcdF8Em7s
Precious Metals	The Russian Futurists	Let's Get Ready To Crumble	spotify:track:6uxT6rULGysuM10W4OVK2K
Let's Get Ready To Crumble	The Russian Futurists	Let's Get Ready To Crumble	spotify:track:609hN3ebMYiU5tEkPyvf9y
One Night, One Kiss	The Russian Futurists	The Weight's On The Wheels	spotify:track:7LPO591lE7nW7EJ1ZUxG6V
Paul Simon	The Russian Futurists	Me, Myself and Rye	spotify:track:3KRIhBerFsfSjH6MrG9sDm
(It Could Be) Love	Camouflage Nights	Camouflage Nights	spotify:track:4ZZE0mNVwM8EmghXbyfh4o
Five Five Minutes	Camouflage Nights	Camouflage Nights	spotify:track:0cDpsy0fmAIRs64MNlmSO5
Antarctica	Camouflage Nights	Camouflage Nights	spotify:track:0Gpe1yrSYdEtYsKBBidfGd
When We Get Home Tonight	Camouflage Nights	Camouflage Nights	spotify:track:2evKudlsva4uVIdDO0prlF
The End of August	Camouflage Nights	Camouflage Nights	spotify:track:3qz6ISMtEL3jfj5IJoEHGn
Wait up for You	The Belle Game	Ritual Tradition Habit	spotify:track:5g6v9y8m1bJyJmkXCqt0PP
Only One	The Belle Game	Only One	spotify:track:49QizaWKRvSa14ebLOiLEt
Tradition	The Belle Game	Ritual Tradition Habit	spotify:track:6YIX9jxNfhnnuE2VhVlmmz
Spirit	The Belle Game	Fear/Nothing	spotify:track:3nxiBibGuMnhbXjrOVHriI
River	The Belle Game	Ritual Tradition Habit	spotify:track:2Q4Kb9FyPeZY2yW8qZSwN5
WEIGHT OFF	KAYTRANADA, BADBADNOTGOOD	99.9%	spotify:track:2vWxvpycD0ELvOJr6g4pQt
In Your Eyes	BADBADNOTGOOD, Charlotte Day Wilson	IV	spotify:track:3ASXl6RsPDxZElS8Qmv2UB
Time Moves Slow	BADBADNOTGOOD, Sam Herring	IV	spotify:track:61yfA2rLdxuaBncErNPnBY
nervous	Jonah Yano, BADBADNOTGOOD	nervous	spotify:track:1q1RaVa0I7TN8SqSoLGIcP
Hedron	BADBADNOTGOOD	Late Night Tales: Bonobo	spotify:track:10lGufP5RmCsUwKDTcPpxs
Glue	Bernice	Puff: In The Air Without A Shape	spotify:track:0gJYGDUJKq7rMDvJzMBPJF
He's The Moon	Bernice	Puff: In The Air Without A Shape	spotify:track:16y9EHfDv2ANmDzxrs4zQp
Passenger Plane	Bernice	Puff: In The Air Without A Shape	spotify:track:2iFgaiCTkxJhv4Bxc7z5o0
St Lucia	Bernice	Puff	spotify:track:7jSy056qtOByCJAg75yILK
David	Bernice	Puff: In The Air Without A Shape	spotify:track:1mwSATb2pxSgMvdNgs0lwX
Camilo - The Magician	Said The Whale	Islands Disappear	spotify:track:2JJ9gp9kG8vhW5V97LDvRL
UnAmerican	Said The Whale	Cascadia	spotify:track:0qSTijeNE9JwdrU1HUmWhY
Record Shop	Said The Whale	Cascadia	spotify:track:44jvccYToFFYHqP7IiGIRT
I Love You	Said The Whale	hawaiii	spotify:track:45g3mVFQOWb2isoj2Swwil
Level Best	Said The Whale	Cascadia	spotify:track:1vjHTiQG1HO1ly4PJB2vaU
Westworld	Valley of the Giants	Valley Of The Giants	spotify:track:6c48qLXdVgVou32e7WIAIJ
Bala Bay Inn	Valley of the Giants	Valley Of The Giants	spotify:track:6lGCtYqiPKyolpvXjSIyqM
Whaling Tale	Valley of the Giants	Valley Of The Giants	spotify:track:01rey7ZUD44uM7ES568xdN
Claudia & Klaus	Valley of the Giants	Valley Of The Giants	spotify:track:7qwdlF7GkRWcvNwH81sgW0
Cantara Sin Guitara	Valley of the Giants	Valley Of The Giants	spotify:track:5bagPaUhSylkerxfKLUBRi
I'll Be Around	Yo La Tengo	Fade	spotify:track:4I5kQyAYTvwHEIiZIP8B2j
Autumn Sweater	Yo La Tengo	I Can Hear The Heart Beating As One	spotify:track:4R7kumtHnf5SsKyPYrVO5r
My Heart's Not In It	Yo La Tengo	Stuff Like That There	spotify:track:1XoRSyXWm7Vou7z11Z2j5Z
You Can Have It All	Yo La Tengo	And Then Nothing Turned Itself Inside-Out	spotify:track:4GrfClvQgCVLsCfqw7YthQ
Green Arrow	Yo La Tengo	I Can Hear The Heart Beating As One	spotify:track:0jgsq6l1yMZIlJX4AFXAgA
Polish Girl	Neon Indian	Era Extraña	spotify:track:5g3TDpgy1J1woAUVuj21EE
Annie	Neon Indian	VEGA INTL. Night School	spotify:track:0GaDEH6o2nxvqRPqNTCtET
Change Of Coast	Neon Indian	The Music of Grand Theft Auto V, Vol. 1: Original Music	spotify:track:4Zehi1XQ5vKkIxMoqZ1L38
Deadbeat Summer	Neon Indian	Psychic Chasms	spotify:track:0O3YOl3BI4iKDByiTNvk1a
Heaven's Basement (Theme From 86'd)	Neon Indian	Heaven's Basement (Theme From 86'd)	spotify:track:1Wmg5pfNyyZw02sIifksbW
The Mark - Live Solo	Cold Specks	Spotify Session	spotify:track:5QJMMpa8ihBI2CFEhhmOi4
Send Your Youth	Cold Specks	I Predict A Graceful Expulsion	spotify:track:640LAhQg01Zfrc2RENHC9A
Blank Maps	Cold Specks	I Predict A Graceful Expulsion	spotify:track:6Wx91AmV8pafMevxw9NKuM
The Mark	Cold Specks	I Predict A Graceful Expulsion	spotify:track:1wOMUuf5DF97Chw262AQSM
Wild Card	Cold Specks	Fool's Paradise	spotify:track:04ztqWHkUZXNL4vEKX380f
Baltimore Blues No. 1	Deer Tick	War Elephant	spotify:track:3Dy8QNZ77cre9ThUPRguy0
Twenty Miles	Deer Tick	The Black Dirt Sessions	spotify:track:69XEXAbJTZwFfVz7ayfg3I
Rough Around the Edges	Deer Tick	Rough Around the Edges (Covered by John McCauley)	spotify:track:6yg3nUjAH2gR8VPBpPHTyj
The Dream's In The Ditch	Deer Tick	Negativity	spotify:track:2A9Zm100yFB3CHQd6kFaB7
Ashamed	Deer Tick	War Elephant	spotify:track:2ABEqmtYRhPmMIkX8aj4SY
Hummingbird	Born Ruffians	Red, Yellow & Blue	spotify:track:0YNjN8GzHJdz96fbSzUd21
Foxes Mate For Life	Born Ruffians	Red, Yellow & Blue	spotify:track:2R0y7UJEqS7ltOC2LZAGKj
Your Sufferin' Heart	Born Ruffians	Birthmarks (Deluxe Edition)	spotify:track:0uTViNjOOaiFatlfrbXT6A
Fade to Black	Born Ruffians	Uncle, Duke & The Chief	spotify:track:2mcxqQLC3C9Gp8ToxdI5gM
Cherry Wine	Born Ruffians	Birthmarks (Deluxe Edition)	spotify:track:6E6Z2QyOPcmlZgmfRSEYaE
Monster [RAC Mix]	You Say Party! We Say Die!	Remik's Cube	spotify:track:1W74kL1ALTgP8QLdha1CXs
There Is XXXX (Within My Heart)	You Say Party! We Say Die!	XXXX	spotify:track:34iLl3XNpM1B1GFCPfT3dB
Cold Hands! Hot Bodies!	You Say Party! We Say Die!	Hit The Floor!	spotify:track:5cBgWkM3GrbIGh9Ya7qDkv
The Gap (Between The Rich And The Poor)	You Say Party! We Say Die!	Hit The Floor!	spotify:track:3s5cyLbbChwTb7TSFNGQyg
Laura Palmer's Prom	You Say Party! We Say Die!	XXXX	spotify:track:6qHzNEWmQDS6wuianrfhvn
If I Live or If I Die	Cuff the Duke	Sidelines of the City	spotify:track:43tfgIQDa2fr0cy8IrttI3
Take My Money and Run	Cuff the Duke	Cuff the Duke	spotify:track:7KJHC1TV567SPO1H7BUfRq
Ballad of a Lonely Construction Worker	Cuff the Duke	Life Stories for Minimum Wage	spotify:track:7L8GD0mAYZd2gCJpkGzUxt
Count On Me	Cuff the Duke	Morning Comes	spotify:track:6LyG43zJTByBr7Mf3wE6sC
Belgium or Peru	Cuff the Duke	Cuff the Duke	spotify:track:7onuqvoJRLGIeEXPaTH6AV
Facelove	PS I Love You	Meet Me At The Muster Station	spotify:track:6C1Cj9uWGUaCpT8vAunDFd
Starfield	PS I Love You	Figure It Out	spotify:track:46o1fHLE4sRcXOFkXnYDhE
More of the Same	PS I Love You	For Those Who Stay	spotify:track:1RvyHGum04MYicVeFPO6B7
Subtle And Majestic	PS I Love You	Figure It Out	spotify:track:55MpsLvP0TpiD5DVvRB1Co
Scattered	PS I Love You	Figure It Out	spotify:track:23Z8e7WSUbd9AXjRez8BCF
Eye Of The Tiger	The Rural Alberta Advantage	Drain The Blood	spotify:track:1oTogfbs83WR775OZ0AfpR
Brother	The Rural Alberta Advantage	The Wild	spotify:track:77QJe0ucvYrpdiRNup3cmY
Frank, AB	The Rural Alberta Advantage	Hometowns	spotify:track:6souW7V3nJJ41hudDRtdH9
Bad Luck Again	The Rural Alberta Advantage	The Wild	spotify:track:6FV9PPTi5TMHo7zRdhJflE
White Lights	The Rural Alberta Advantage	The Wild	spotify:track:5cOFdaE0xO6DS1dYiqPDeW
Minotaur Forgiving Knossos	Moonface, Spencer Krug	This One’s for the Dancer & This One’s for the Dancer’s Bouquet	spotify:track:79qmWIr4P5og23flUgjFvO
Barbarian	Moonface, Spencer Krug	Julia With Blue Jeans On	spotify:track:1gsFdhKyMeUwwnekwEuqUw
Minotaur Forgiving Pasiphae	Moonface, Spencer Krug	This One’s for the Dancer & This One’s for the Dancer’s Bouquet	spotify:track:7GyAdITCCQ8214l4DEJpcL
Heartbreaking Bravery II	Moonface, Spencer Krug	This One’s for the Dancer & This One’s for the Dancer’s Bouquet	spotify:track:4JFXvvcp1PJHoSNtVLzXLV
Dreamsong	Moonface, Spencer Krug	This One’s for the Dancer & This One’s for the Dancer’s Bouquet	spotify:track:5bkSu0unA20gADmzb4t8LA
Black Cloud	POSTDATA	Let's Be Wilderness	spotify:track:216vjlnFVeCAHaS48vTLtv
Evil	POSTDATA	Let's Be Wilderness	spotify:track:2mRTVKtK4l9OVQKIVlqpsq
Wilderness	POSTDATA	Let's Be Wilderness	spotify:track:5ywAlt9l3g9ZesXEqvp2rL
Gravity	POSTDATA	Let's Be Wilderness	spotify:track:4ubmKzeDqKSqrrAuPobd5A
Pasture	POSTDATA	Let's Be Wilderness	spotify:track:4l496jUVgHrkPIc2RoT8Qg
New Survival	Ellevator	New Survival	spotify:track:2V48MQXldHg2C04h5HnXQi
St. Cecilia	Ellevator	St. Cecilia	spotify:track:6qqwZKNH50LajVk69veogY
Hounds	Ellevator	Hounds	spotify:track:3dBXis0be6SAanvn1A5Dvl
The Storm	Ellevator	The Storm	spotify:track:025Ceu5qGc7YtyNTileKm7
Dirt	Ellevator	Dirt	spotify:track:5888SVDZjAxUjDOlFbmigH
You Amaze Me	La Force	La Force	spotify:track:4glyfm0RcIHBG5TYdqt6lz
Lucky One	La Force	La Force	spotify:track:5jd9yccsOqV2nI5NvoiygW
The Tide	La Force	La Force	spotify:track:6QtkJ3ZisnpSfX6D4x6Fo0
Mama Papa	La Force	La Force	spotify:track:730ciYHhHp6pbXrq5sSNdk
Je suis libre	La Force	Je suis libre	spotify:track:5Lowk70t8gayvXlScEcIgh
Kill Me	Dead Soft	Kill Me	spotify:track:6KuT5fa3Vfz3QkkOe4iDC1
The Static	Dead Soft	The Static	spotify:track:7sC82p9Sg5yVjG2SqsUzZb
Never Forever	Dead Soft	Dead Soft	spotify:track:5I9j7mgt8WPvG2auIPZwEi
Porch	Dead Soft	Porch	spotify:track:2YXiH9TqIW97aklwTah4yM
Bones	Dead Soft	Bones	spotify:track:7cMNmVVOYkX8xRDQXJqTp3
You! Me! Dancing! - Remastered	Los Campesinos!	Hold On Now, Youngster... (Remastered Deluxe Edition)	spotify:track:0BiYKvf5gJ9bGNJnngyDkU
Avocado, Baby	Los Campesinos!	No Blues	spotify:track:62iNIsckErsDyuaZUvvJMV
The Sea Is A Good Place To Think Of The Future	Los Campesinos!	Romance Is Boring	spotify:track:7weuYg0z1hZkbN71cAC9fh
By Your Hand	Los Campesinos!	Hello Sadness	spotify:track:3foIz1yabvQYi3vNUVDw5U
A Slow, Slow Death	Los Campesinos!	Sick Scenes	spotify:track:1pSxSzTOagc2WjWx09lnWv

Look Into
Waiting For A War	The Morning Benders	Talking Through Tin Cans	spotify:track:3DrIpkN7MNVqme2MmyuqqD
Friday I'm In Love	Glo-Worm	Glimmer	spotify:track:2tBcVd3jcWbLbfzvaVOLFO
Silver Spoon	The Felt Tips	Living And Growing	spotify:track:5mrIDP5sBU6X5FKIIylMLW
Fleeting Moments	Pocketbooks	Flight Paths	spotify:track:4XiX7VWhtf3enXxkqmFlGh
Other Girls	Eux Autres	Hell Is Eux Autres	spotify:track:4iOn9PadizlBFMvpHuNiR8
Not a Through Street	Anya Marina	Slow & Steady Seduction: Phase II	spotify:track:1GYQGqQZFkMiyRKNujeYhb
Rudderless - Remastered	The Lemonheads	It's A Shame About Ray (Expanded Edition)	spotify:track:2afHIrkzrlFs7EmbMiv1kP
Stars	Au Revoir Simone	The Bird Of Music (Bonus Track)	spotify:track:6MJr8dIrstEQQSiEdxzLrh
Corelli - La Folia	Emilie Autumn	Laced/Unlaced (Double Disc)	spotify:track:5lEB6n1M2jhO4vPVSQAWGY
Bourgeois Shangri-La	Miss Li	Dancing the Whole Way Home	spotify:track:049q0MHQXbPWVvUnQOvWHt
Heaven Is For Easy Girls	The Awkward Stage	Heaven Is For Easy Girls	spotify:track:3qAgiPMTksejr4GLP5HMMJ
Les Baricades Mistérieuses (6e ordre)	François Couperin, Alexandre Tharaud	Couperin: Tic Toc Choc	spotify:track:1Q9JMojxHHF6JbEJAKJLgj
On the Beautiful Blue Danube - Waltz Op. 314	Johann Strauss II, Hallé, Bryden Thomson	Johann Strauss II Waltzes, Polkas & Overtures	spotify:track:4EInsYD17L0w7jXY9PMSUS
Humoresque, Op. 101, No. 7	Antonín Dvořák, Kim Dami	Dvorak	spotify:track:76oR5f6zl5jpJ6zKBNXL3g
Ebonics (Criminal Slang)	Big L	The Big Picture	spotify:track:65qPYjxlLmw8hmK4oWIdX4
On the Radio	The Concretes	The Concretes In Colour	spotify:track:7BvPWah3dB1esQ4msJq2wG
Oats We Sow	Gregory and the Hawk	Moenie and Kitchi	spotify:track:3KypGLbVcw38bSV9Ehvgl5
Seventeen Forever	Metro Station	Metro Station	spotify:track:1v0E30pA3wOBXuDxfsyOPa
The Start Of Something	Voxtrot	Raised By Wolves EP	spotify:track:6K5GAopLZzzg0ZX8k5GWwh
Run My Mouth	Ra Ra Riot	The Rhumb Line	spotify:track:4ZYhHvc0d1ZSeIoJOsMsMQ
Suspended In Gaffa	Ra Ra Riot	The Rhumb Line	spotify:track:4wDZsWiM6MDCspJq73n78e
Cumbia bruja	Dusminguet	Postrof	spotify:track:4NK2lzxWY6JL7rk4tcbTDt
Dark Star	Deine Lakaien	Dark Star & 2nd Star	spotify:track:1pHgR8XWoRluHPrbRqgTiN
Click, Click, Click, Click	Bishop Allen	The Broken String	spotify:track:0frc8p7mSoCjrdyhgUcNhR
Jane Says	Jane's Addiction	Nothing's Shocking	spotify:track:7c1Dar0pIAW7w5TzaGjt9t
Jane Says - Live	Jane's Addiction	Kettle Whistle	spotify:track:1atCEBZJgOcoajj0sWzn1x
Couperin, F: Second Livre de pièces de clavecin, Sixième Ordre: V. Les Baricades mistérieuses	François Couperin, György Cziffra	François Couperin Edition	spotify:track:2ysQkliFZA3i6ASKD4GVkA
Les Baricades Misterieuses (F Couperin)	Hanneke van Proosdij	Les Baricades Misterieuses	spotify:track:2Jku0irryuhAxXkECEA98A
Deuxième Livre de Pièces de clavecin: Sixième ordre, Les Baricades Mistérieuses	François Couperin, Christophe Rousset	Louis XIV	spotify:track:4dQo9iOO7xWqfhqm7VSZZJ
Me Pnigei Touti I Siopi	Giorgos Karadimos	Fos Kai Vgaino	spotify:track:1mSE9yLnFK3SYdLe1TNw0G

90s Dance Hits
Another Night	Real McCoy	Another Night	spotify:track:3pEuO9J2MTEmec8kUfYYvl
Mr. Vain - Original Radio Edit	Culture Beat	Mr. Vain	spotify:track:4ih3dyFZoeTdaeJW9mPbOI
Beautiful Life	Ace of Base	The Bridge	spotify:track:74jTexO94dFGyXGyeu8krd
This Is Your Night	Amber	This Is Your Night	spotify:track:5p0rUHicpwMZil8RlNGGth
Rhythm Is A Dancer - 7" Edit	SNAP!	The Madman's Return	spotify:track:4RADreHMvMkZwsPgPr9z5c
The Rhythm of the Night	Corona	The Rhythm of the Night	spotify:track:0ofMkI3jzmGCElAOgOLeo3
Barbie Girl	Aqua	Greatest Hits	spotify:track:2ZCTP54O2dMSbVrdsg60to
Blue (Da Ba Dee)	Eiffel 65	Europop	spotify:track:5FgtdSf7I5lClThz2ptWvl
(You Drive Me) Crazy	Britney Spears	Baby One More Time	spotify:track:36sAHywEsh50kaM6CpENHp
Tearin' up My Heart - Radio Edit	*NSYNC	'N Sync	spotify:track:594M0rqYMOo8BhMGEdoi5C
(You Drive Me) Crazy - The Stop Remix!	Britney Spears	Greatest Hits: My Prerogative	spotify:track:6wJB7DTMIJAZuQ0vPLr8H9
Around the World (La La La La La) - Radio Version	A Touch Of Class, Pete Konemann	Planet Pop	spotify:track:7CvOnbFdnIoXMQ4eFCo5lB
My Heart Beats Like A Drum (Dam Dam Dam) - Radio Edit	A Touch Of Class, Le Koma, A. Buggle	Planet Pop	spotify:track:0hRFDhaHRJt6cz69n78G3f
Coco Jamboo - Radio Version	Mr. President	We See The Same Sun	spotify:track:6rQ9qJPvInEqSzlh89LsPJ
I'm in Heaven When You Kiss Me	A Touch Of Class	Touch the Sky	spotify:track:22dodHtFcXmXboE2LPC49q
Heaven	DJ Sammy, D/O	Heaven	spotify:track:72SpPFrMYCXLB3Fbw9tEgf
Ass Up - Original Radio Edit	Baracuda	Ass Up	spotify:track:28x5bKzUrZR7evE7JM0vnr
Be My Lover	La Bouche	Greatest Hits	spotify:track:5Y3W09WHcXPx7eZ7s9gdMs

Zoé
No Me Destruyas	Zoé	Lucha Rock	spotify:track:4t7oxcX57H84tUCpLSnxIF
Soñé - Live	Zoé	MTV Unplugged Música De Fondo (Reissue/Live)	spotify:track:2VhJ4nrPorAbySEgO4V0BS
Azul	Zoé	Aztlán	spotify:track:7ffkdwy4EvMSeUnPVSyqqw

The Interrupters
She's Kerosene	The Interrupters	Fight the Good Fight	spotify:track:60FJeNTK5edr72G2xtCWuP
She Got Arrested	The Interrupters	Say It Out Loud	spotify:track:2MWC3IWfhh3IteOUPbtogB
Title Holder	The Interrupters	Fight the Good Fight	spotify:track:5dt0dBcBTgGb7Gt5hNTG91
Gave You Everything	The Interrupters	Fight the Good Fight	spotify:track:4C0ZP5m9z0pfefQHUhach5
Take Back The Power	The Interrupters	The Interrupters (Deluxe Edition)	spotify:track:6aPyTOZZheIVT5q1TVlRYD

Katy Garbi
Perasmena Xehasmena (Weina al Zeina)	Katy Garbi	A Night In Greece	spotify:track:5t2tgbbL7g1vxi6US7ptCW
To Kati	Katy Garbi	The Digital Collection	spotify:track:7wmumGk9nBkuiuCBBpSpP5
Epitelous	Katy Garbi, Natasa Theodoridou	The Digital Collection	spotify:track:3wsi2YkEIkJeMeHRvHIp0o
Ne Iparho Ego	Katy Garbi	The Digital Collection	spotify:track:4oRQrSDkwzYjr8dwVOEMe7
Mia Fora Ke Enan Kero	Katy Garbi	The Digital Collection	spotify:track:4YZNQrXd26FLbCLLgliNGn
Ti Theloune Ta Matia Sou-Exis	Katy Garbi	The Digital Collection	spotify:track:4yLLMe0zVAwH2j3JHJUMFh
Psihedelia - Live Version	Anna Vissi	Anna Vissi Live	spotify:track:276LAc86qNYrOydSQEb2rv
Epidi Me Xero	Natasa Theodoridou	Pote Den Efiga Apo 'Do	spotify:track:4pBbQ6m0EsnBJSpdqP1tnu
Dikos Sou Gia Pada	Mihalis Rakintzis	Na Ise Eki	spotify:track:4844yHnYbid6IwsN7riJ7x
Ego Ki O Pouf	Mihalis Rakintzis	Na Ise Eki	spotify:track:0hWwF045ltoDqedfdIa42f
Prokalis	Mihalis Rakintzis	Apagogi	spotify:track:1EQO4OsaYQBkyA2xoXzLP6

Because the Night
Toccata in E Minor, BWV 914	Johann Sebastian Bach, Yoshiko Ieki	Toccatas, Vol. 1	spotify:track:6UjlytDxWZB2tTU9Xi4UCa
Non ti scordar mai di me	Giusy Ferreri	Gaetana	spotify:track:5dWDWnIlasGDHFqTkfsWrm
Je bois et puis je danse	Aline	Regarde le ciel	spotify:track:3jLwMCiCa8zVkS4u5jJIJ4
Les copains	Aline	Regarde le ciel	spotify:track:17WLjlFHV2QuBl50ASqH5w
To Kati	Katy Garbi	The Digital Collection	spotify:track:7wmumGk9nBkuiuCBBpSpP5
Perasmena Xehasmena (Weina al Zeina)	Katy Garbi	A Night In Greece	spotify:track:5t2tgbbL7g1vxi6US7ptCW
La vie électrique	Aline	La Vie Electrique	spotify:track:5LOVbmE0hrPgcnoR3DgglO
Vertige Exhaussé	Pendentif	Vertige Exhaussé	spotify:track:3l5dpgMfE9bA7a10EWI6Dz
Vas-Y Fais-Le Vite	Pendentif	Vertige Exhaussé	spotify:track:2xc0jckzB8gHdhv0LF6Qmw
Embrasse Moi	Pendentif	Embrasse Moi / Jerricane	spotify:track:4deCV2tRwFGQJTpy2CZlZp

Diana y Yo
Lamento Boliviano	Los Enanitos Verdes	Coleccion Aniversario	spotify:track:62FQCSvSUSG3m9uajVkvWe
Siento Que...	Jumbo	Restaurant	spotify:track:1VtBjpwh6xdRPDy20Uln3W
Hoy Tengo Miedo	Fobia	Rosa Venus	spotify:track:7dkzqJnqaLDEH8MsP1Rxx7
No Soy un Buen Perdedor	Fobia	Rock Latino	spotify:track:31SakA8wdFowqJyzGxuDzJ
No Eres Yo	Fobia	Rosa Venus	spotify:track:78SXzmCl63Rb2SGqAjHUs8
Hipnotízame	Fobia	Amor Chiquito	spotify:track:7qHyrmULvIEtblpdClGzPi
Veneno Vil	Fobia	Amor Chiquito	spotify:track:7lBKa0oQnv6w2AgFiBqRW2
El Diablo	Fobia	Rock En Español - Lo Mejor De Fobia	spotify:track:1PMcUPgdnUZm1Lo74VUrK2
No Me Destruyas	Zoé	Lucha Rock	spotify:track:4t7oxcX57H84tUCpLSnxIF
Deja Te Conecto	Zoé	Zoe Exitos	spotify:track:3shZzM0qPEx8o6kTYVPRZt
Miel	Zoé	Zoe Exitos	spotify:track:1L8TwjgQ8kgvFJbpp2ODiO
Soñé - Live	Zoé	MTV Unplugged Música De Fondo (Reissue/Live)	spotify:track:2VhJ4nrPorAbySEgO4V0BS
Tu Casa Nueva	El Último Vecino	Tu Casa Nueva	spotify:track:5LBTfYRqAadXE8DW7gzSPu
Antes de Conocerme	El Último Vecino	Voces	spotify:track:0ZMdACMaGhScrsNcEnaVOb
Tornasol (Vuelves a Ser)	La Gusana Ciega	La Gusana Ciega	spotify:track:1BaNzcWE5fAJ6Ujh1CytzN
Estático	Zurdok	Maquillaje	spotify:track:0uZvNFgJxJnwFF7pQycIzH

tmp
My Number	Foals	Holy Fire	spotify:track:4c9WmjVlQMr0s1IjbYO52Z
Wish I Knew You	The Revivalists	Men Amongst Mountains	spotify:track:2EWpa5XnAuSn0sIkSSIhYk
Zona Autónoma Permanente	Los Planetas	Zona Temporalmente Autónoma	spotify:track:2airh3ucZQNbiOqSAvQBZX
This is Radio Clash	The Clash	Hits Back	spotify:track:7sQkeztZAGR3haZL71wvZe
Óleo de Mujer Con Sombrero	Silvio Rodríguez	Al Final de Este Viaje...	spotify:track:1w6mcMacExya7bvbElMuar
You're My Favorite Waste of Time - Remastered Version	Marshall Crenshaw & The Handsome, Ruthless and Stupid Band	This Is Easy: The Best Of Marshall Crenshaw	spotify:track:5kVuwpCtLAqAfND2X7x7tg
Chartered Trips	Hüsker Dü	Zen Arcade	spotify:track:7jmIBvIkPcAR6yzbR7YsJH
This Woman's Work	Kate Bush	The Sensual World	spotify:track:4F6ihtOUcj1uLWdSkc1RzG
Wuthering Heights	Kate Bush	The Kick Inside	spotify:track:5YSI1311X8t31PBjkBG4CZ
Poison	Bell Biv DeVoe	Poison	spotify:track:6m59VvDUi0UQsB2eZ9wVbH
All For You	Janet Jackson	All For You	spotify:track:5X8kkUaUlAyAUr9TYqDFTH
Touch of Grey	Grateful Dead	The Very Best of the Grateful Dead	spotify:track:5YzzWlWfAVNvtduNDHKhHc
"This Is Seagull…."	The Snake Corps	Smother Earth	spotify:track:5jCOeqjJRnRo27b9Hb8xHp
Butterfly On A Wheel	The Mission	Carved In Sand	spotify:track:2d1vGDzaGWbCkupDsPniA7
Wasteland	The Mission	Gods Own Medicine	spotify:track:4kiVRcINxpbNTbmEbePXQL
Mountain Energy	The Fall	Country On The Click	spotify:track:2y4HRAVsKkBXVHyCaTUiE6

The Heights
Toma y Toma	Ramón Orlando	1	spotify:track:7hIMyE71NT7GFTtlLTb9BZ
Yo Quisiera Enamorarme	La Makina	1	spotify:track:2Ol5wxatHOPchkCVpgogXG
No Vuelvas - Original Mix	Tisu	No Vuelvas	spotify:track:53CB5G2BZsOkgoKLBNjL1O
Es Mentiroso	Olga Tañón	100% Merengue	spotify:track:31usVfDz8LKV0J0iZtgsA7
En Anillo	Los Hijos De Puerto Rico	Merengue De Amor Vol.1	spotify:track:13Q3mvc09pwUC4EkkYAyTQ
Abusadora	Wilfrido Vargas	Coleccion Diamante	spotify:track:2aDFka2ORQkraeJXkYkGxl
Si Una Vez	Manny Manuel	Contra La Marea	spotify:track:7EBmT9Uhaidxbg0lnVniq3
La Dueña del Swing	Los Hermanos Rosario	Latino! Greatest Hits - 56 Latin Top Hits (Original Versions!)	spotify:track:3vCeDhrInX8te6SoaqZbvu
Estás Enamorada	Limi-T 21	La Historia	spotify:track:6RwiMja5FdaP8mKCRlg6jl

DJ Pajamas
It's All Coming Back	INVSN	INVSN	spotify:track:7Jbo2BG3fHQ47NtRqBDpJR
Come & See	Protomartyr	Under Color of Official Right	spotify:track:0kY8guWctD1G5A3Cx66Ruj
Gallowdance	Lebanon Hanover	Tomb for Two	spotify:track:74SUn8w4lYSwgOGPvVZiEo
Dead End Roads	The Foreign Resort	New Frontiers	spotify:track:3d0smnPTcSxe6lKJGZ9DK8
The World Fell	Vår	No One Dances Quite Like My Brothers	spotify:track:2JFLQi4R9RTsbhtgve51Ag
Behind Curtains	Lust For Youth	Growing Seeds	spotify:track:4A8cYMsdyfa3YMqQQSfnCD
Bunker Buster	Preoccupations	Viet Cong	spotify:track:7rqZJ8JM8nlNHb4p8eCSTR
Dream Of My Love (Chasing After You)	Abe Vigoda	Crush	spotify:track:7atkch3SlhNhu7QcrjDxi7
Sea Within A Sea	The Horrors	Primary Colours	spotify:track:6NwkAlnyJTL5mPAQuK3i36
All I Want	LCD Soundsystem	This Is Happening	spotify:track:4Cy0NHJ8Gh0xMdwyM9RkQm
Nobody Lost, Nobody Found	Cut Copy	In Ghost Colours	spotify:track:6M8vW8qg2RkqRNke2QM3n9
Fall Back	Factory Floor	Factory Floor	spotify:track:3xPNdpvvf7PGdfpdp0LC45
Unconscious Melody	Preoccupations	Cassette	spotify:track:58ITGKThH6gQ4qfkir8kKb
Continental Shelf	Preoccupations	Viet Cong	spotify:track:3d5lGpqxg1cMEYrgTaGxZy
Disarray	Preoccupations	New Material	spotify:track:2QlYpno65G6IJ2X3Yp4V9L
Espionage	Preoccupations	New Material	spotify:track:1FGEDA1ZI90eSbLIEirmFZ
Pontiac 87	Preoccupations	Pontiac 87	spotify:track:0glyuEiAzmJCbLPGWeqv8k

Goth
Now I’m Feeling Zombified	Alien Sex Fiend	Gothic Essential Tracks	spotify:track:1pfHaFZ6WsTcYHhqbTYIJb
Down In The Park (20th Anniversary Edition)	Gary Numan	Gothic Essential Tracks	spotify:track:4L8cEQHfLseP2vUm0tAhdR
Gothic Girl	The 69 Eyes	Gothic Essential Tracks	spotify:track:5FFvaskWpkLIgBdNhlSIOG
Nazarene	The Wake	Gothic Essential Tracks	spotify:track:4mvix1KCaVMcpTiG5ns8Le
Girls And Boys	Fear Cult	Gothic Essential Tracks	spotify:track:7EbM22Np26kBzmfQnM8pyg
Every Day Is Halloween	Ministry	100 Gothic & Industrial For Vampires & Halloween	spotify:track:34eecfC5c2nMfkHW8Q6zQf
Lucretia My Reflection	Vampire Lust	100 Gothic & Industrial For Vampires & Halloween	spotify:track:1RljcjBO3vRP87KfHogA27
Spirit Walker	The Cult	Gothic Rock 3 - Black on Black	spotify:track:0D9AipfCfkOiWzCCObsXe6
Do You Believe in the Westworld?	Theatre Of Hate	Gothic Rock 3 - Black on Black	spotify:track:1cZn8L6KfAtrQAbFlejzDm
Blue Water	Fields Of The Nephilim	Gothic Rock 3 - Black on Black	spotify:track:5EyGSSUhob7JETn3sLrs0u
The Hungry Years - Edit	Marc Almond, Andi Sex Gang	Gothic Rock 3 - Black on Black	spotify:track:4HblgEEwLzLxtUOj9SkAgj
Bittersweet	New Model Army	Gothic Rock 3 - Black on Black	spotify:track:2kgQcENRtfRm8cmujlSUN2
Walking on Hands	Red Lorry Yellow Lorry	Gothic Rock 3 - Black on Black	spotify:track:3WFP33RShJu74XUZ2m3wwH
Sebastiane	Sex Gang Children	Gothic Rock 3 - Black on Black	spotify:track:1MBf40gLt0sgBSSJ5JjHe1
Somewhere	The Danse Society	Gothic Rock 3 - Black on Black	spotify:track:6dVSjVgV0l1zOj1Jxq5Kt3
13 Floor Vendetta - His Masters Delight	The Damned	Gothic Rock 3 - Black on Black	spotify:track:4K4DPsF2Uv4onZmM1glX23
Questioning the Shadow	Ritual	Gothic Rock 3 - Black on Black	spotify:track:6xA1GLcisYYDhmiy4YRMgc
Cry Wolf	1919	Gothic Rock 3 - Black on Black	spotify:track:3ZzTFzTPcpfgT0ro6cKTws
A Dream of Yesterday	Screaming Dead	Gothic Rock 3 - Black on Black	spotify:track:1yeDNqVNBkV8gFA1li3IHp
Do You Believe in the Westworld?	Theatre Of Hate	Gothic Rock 3 - Black on Black	spotify:track:1cZn8L6KfAtrQAbFlejzDm
Blue Water	Fields Of The Nephilim	Gothic Rock 3 - Black on Black	spotify:track:5EyGSSUhob7JETn3sLrs0u
The Hungry Years - Edit	Marc Almond, Andi Sex Gang	Gothic Rock 3 - Black on Black	spotify:track:4HblgEEwLzLxtUOj9SkAgj
Bittersweet	New Model Army	Gothic Rock 3 - Black on Black	spotify:track:2kgQcENRtfRm8cmujlSUN2
Walking on Hands	Red Lorry Yellow Lorry	Gothic Rock 3 - Black on Black	spotify:track:3WFP33RShJu74XUZ2m3wwH
Sebastiane	Sex Gang Children	Gothic Rock 3 - Black on Black	spotify:track:1MBf40gLt0sgBSSJ5JjHe1
Somewhere	The Danse Society	Gothic Rock 3 - Black on Black	spotify:track:6dVSjVgV0l1zOj1Jxq5Kt3
13 Floor Vendetta - His Masters Delight	The Damned	Gothic Rock 3 - Black on Black	spotify:track:4K4DPsF2Uv4onZmM1glX23
The Black Cat - Alt. Take	London After Midnight	Selected Scenes from the End of the World	spotify:track:6IQVEjfLUChdMjeUm2guMO
Spider and The Fly	London After Midnight	Selected Scenes from the End of the World	spotify:track:54rZiCq2jCgdiuTHc8273s
Kick in the Eye	Bauhaus	Mask	spotify:track:5W37qNb9oL9jjRQgHDZ7wT
In the Flat Field	Bauhaus	In The Flat Field	spotify:track:1EELkU8hWhdP3pmBFj0ozZ

